absent|abstracted|absentminded|scatty|inattentive
abstract|nonobjective|nonrepresentational|abstractionist|nonfigurative
abuse|insult|contumely|revilement|vilification
accessory|auxiliary|adjunct|supportive|ancillary|adjuvant|appurtenant|subsidiary
accredited|authorized|licenced|authorised|commissioned|licensed
accurate|veracious|high-fidelity|right|correct|surgical|faithful|precise|exact|true|close|dead on target|hi-fi|dead-on|straight
acid|venomous|caustic|vitriolic|unpleasant|acerbic|acrid|sulfurous|acerb|virulent|blistering|bitter|sulphurous
acoustic|acoustical|physics|physical science|natural philosophy
acquire|adopt|take on|take|assume
acres|landed estate|estate|demesne|land
active|astir|hot|athletic|quick|about|acrobatic|nimble|overactive|spry|agile|hyperactive|on the go|sporty|gymnastic|lively|energetic
acute|needlelike|sharp|pointed|acuate
adaptive|adaptative|adjustive|adaptational|accommodative|reconciling
addiction|dependency|dependence|habituation|dependance
adequate|adequate to|satisfactory|capable|competent|equal to|up to
adjacent|neighboring|connected|contiguous|conterminous|adjoining|abutting
adult|mature|fully grown|full-grown|grown|big|grownup
advert|advertizin|ad|advertising|advertizement|advertisement
advise|give notice|notify|apprise|send word|apprize
advisory|informatory|consultatory|informative|consultative|consultive
aerial|aery|unreal|ethereal|airy|insubstantial|aeriform|unsubstantial
affair|liaison|affaire|intimacy|involvement|amou
affect|pretend|dissemble|feign|sham
affected|artificial|stilted|constrained|studied|contrived|unnatural|elocutionary|hokey|forced|mannered|strained|agonistic|plummy|deliberate
affiliated|attached|related|related to|connected
affordable|low-priced|cheap|low-cost|inexpensive
afraid|agoraphobic|mysophobic|afeared|aquaphobic|fearful|claustrophobic|terrified|panic-struck|xenophobic|apprehensive|dismayed|shocked|bullied|horror-stricken|panic-stricken|aghast|petrified|algophobic|white-lipped|frightened|triskaidekaphobic|panicked|terror-stricken|appalled|scared|afeard|hunted|hangdog|terror-struck|unnerved|alarmed|horrified|timid|hydrophobic|panicky|numb|intimidated|acrophobic|browbeaten|horror-struck|cowardly|cowed
afterwards|after|later|subsequently|afterward|later o
agency|government agency|office|bureau|federal agency|authority
aggregate|aggregated|collective|mass|aggregative
aggressive|predatory|ravening|rapacious|scrappy|vulturine|offensive|raptorial|combative|assertive|battleful|bellicose|hostile|self-asserting|competitive|high-pressure|obstreperous|rough|vulturous|militant|pugnacious|truculent|in-your-face|self-assertive|hard-hitting
agree|harmonize|harmonise|concord|fit in|consort|accord
alert|aware|alive|cognizant|awake|cognisant
almost|all but|most|about|virtually|well-nig|nearly|just about|nigh|near
alone|lone|lonely|solitary|unaccompanied
also|besides|likewise|too|as wel
amateur|inexpert|unskilled|amateurish|unprofessional
amend|meliorate|better|ameliorate|improve
amino|paraffin series|alkane|alkane series|paraffin|aminic|methane series
analyze|study|examine|canva|analyse|canvass
angry|smoldering|mad|sore|smouldering|indignant|furious|huffy|outraged|livid|maddened|ireful|provoked|angered|black|umbrageous|infuriated|incensed|aggravated|wrathful|irate|enraged|hot under the collar|irascible|wrothful|choleric|wroth
animal|fishlike|ameba-like|horselike|shrimp-like|goat-like|elephant-like|ant-like|alligator-like|sloth-like|snail-like|vole-like|scorpion-like|amoeba-like|mongoose-like|perch-like|quail-like|snake-like|pike-like|siskin-like|ostrich-like|snake-shaped|grub-like|cod-like|horse-like|stork-like|cricket-like|duck-like|sparrow-like|hawk-like|carp-like|spitz-like|beaver-like|eaglelike|lobster-like|moth-like|reptile-like|starfish-like|thrush-like|animal-like|bee-like|insectlike|dinosaur-like|hawklike|eagle-like|troutlike|cicada-like|crocodile-like|monkey-like|cranelike|insect-like|dace-like|raccoon-like|mullet-like|tadpole-like|cow-like|fox-like|antelope-like|lizard-like|birdlike|catlike|shad-like|whippoorwill-like|crane-like|foxlike|tuna-like|pigeon-like|turkey-like|deer-like|sandpiper-like|hare-like|badger-like|bird-like|plover-like|squirrel-like|gull-like|arachnid-like|salmon-like|cat-like|ferret-like|mammal-like|herring-like|trout-like|finch-like|animallike|protozoa-like|fish-like|frog-like|ray-like|mosquito-like|shrike-like|pig-like|rodent-like
animated|full of life|alive|vital|enlivened|spirited|reanimated|revived|lively
announce|foretell|harbinger|annunciate|herald
annoying|nettlesome|plaguy|vexatious|disagreeable|pesky|teasing|irritating|pestiferous|plaguey|galling|bothersome|vexing|pestering
annually|each year|per annum|p.a.|per year
anonymous|unidentified|unknown|unnamed|nameless|anon.
anyway|in any case|at any rate|anyhow|in any event
apparent|patent|evident|plain|obvious|unmistakable|manifest
apparently|evidently|plain|manifestly|plainly|patently|obviously
appliance|gadget|gismo|widge|gizmo|convenience|contrivance|contraption
appointed|appointive|nonelected|nominative|nominated|nonelective|non-elective
aqua|greenish blue|aquamarine|peacock blu|cobalt blue|turquoise
arbitrary|impulsive|discretionary|discretional|absolute|capricious|whimsical
arch|patronizing|patronising|condescending|superior
arctic|cold|glacial|gelid|icy|polar|frigid
armed|brachiate|long-armed|one-armed|armlike
arrange|coiffur|dress|do|set|coif|coiffe
arranged|set|ordered|placed|laid
arrest|pinch|collar|catch|taking into custody|apprehension
artificial|stilted|contrived|unnatural|hokey|affected
artistic|aesthetic|esthetic|pleasing|tasteful
aspect|expression|face|facial expression|look
assembled|amassed|congregate|collected|concentrated|accumulated|massed
assess|appraise|value|evaluate|measure|valuate
assume|adopt|acquire|take|take on
assure|guarantee|secure|insure|ensure
asylum|mental home|institution|insane asylu|psychiatric hospital|mental institution|mental hospital
atom|molecule|spec|mote|particle|corpuscle
atomic|microscopical|minute|atomlike|microscopic
attached|related|related to|connected|affiliated
aurora|sunup|morning|dawn|break of the day|dayspring|sunrise|first light|break of day|cockcro|dawning|daybreak
authentic|echt|unquestionable|genuine|bona fide|veritable
authority|agency|government agency|office|bureau|federal agency
authorized|empowered|licenced|sanctioned|lawful|accredited|canonized|authorised|commissioned|approved|glorified|sceptred|official|sceptered|canonised|legitimate|licensed
auto|machine|car|motorcar|automobile
automatic|autoloading|smart|automated|self-locking|self-moving|self-activating|machine-controlled|self-winding|self-acting|mechanical|semiautomatic|self-loading|self-regulating|machine-driven
automobile|machine|car|motorca|auto
available|on tap|acquirable|easy|on hand|addressable|in stock|accessible|getable|obtainable|open|for sale|ready|procurable|lendable|gettable|purchasable|visible|forthcoming
average|mediocre|fair|ordinary|middling
avoid|head off|deflect|avert|obviate|fend off|ward of|stave off|debar
award|accolade|honour|honor|laurels
aware|alive|alert|cognizant|awake|sensible|conscious|sensitive|cognisant
awareness|consciousness|knowingness|cognisance|cognizance
awesome|impressive|amazing|awing|awful|awe-inspiring
awful|impressive|amazing|awing|awesome|awe-inspiring
back|posterior|rearward|rear|backmost|aft|hindermost|rearmost|hindmost
balanced|harmonious|poised|stable|self-balancing|counterbalanced|symmetrical|counterpoised|well-balanced|proportionate
ball|lump|chunk|clod|glob|clump
bang|slap|bolt|smack|slapdash
bare|au naturel|naked|unclothed|nude
barely|hardly|scarcely|scarce|just
basically|essentially|au fon|fundamentally|in essence
basics|fundamentals|fundamental principle|bedroc|basic principle
basis|base|groundwork|fundament|cornerston|foundation
bean|bonce|dome|attic|noodle|noggin
bear|behave|conduct|acquit|carry|deport|comport
beast|faun|animate being|creature|brute|animal
beat|bushed|dead|all in|tired
beautiful|aesthetic|esthetic|aesthetical|esthetical
become|get over|get ahead|get along|go|get on|get
becoming|comely|decent|decorous|proper|comme il faut|seemly
begin|start|set about|commenc|set out|get down|get|start out
belief|impression|notion|feeling|opinion
belong|consist|lie|lie in|dwell
belt|bang|smash|knock|bash
benjamin|gum benjamin|gum benzoin|asa dulcis|benzoin
betting|card-playing|dissipated|sporting|indulgent
biblical|sacred writing|religious text|religious writing|sacred text
bind|bond|adhere|hold fast|stick|stick t
bird|hiss|Bronx cheer|razz|boo|hoot|razzing|raspberry|snor
bizarre|flaky|off-the-wall|unconventional|outlandish|freakish|freaky|flakey|outre|eccentric|gonzo
black|negroid|negro|dark-skinned|non-white|Afro-American|colored|dark|coloured|African-American
blah|bombast|fustian|claptrap|rant
blame|infernal|darned|cursed|damned|blasted|blessed|goddam|curst|blamed|deuced
blanket|all-encompassing|extensive|all-inclusive|broad|across-the-board|wide|all-embracing|panoptic|encompassing|comprehensive
blast|clap|bam|eruption|bang
blink|eye blink|nictation|winking|wink|nictitation|blinking
blond|fairish|platinum-blonde|flaxen|sandy|blonde|redheaded|ash-blonde|fair|nordic|light-haired|towheaded
blonde|light-haired|fairish|platinum-blonde|flaxen|sandy|blond|redheaded|fair|nordic|ash-blonde|towheaded
blood|bloodline|origin|ancestry|stoc|line of descent|descent|parentage|line|stemma|blood line|lineage|pedigree
blue|aristocratical|gentle|noble|aristocratic|blue-blooded|patrician
blues|vapour|blue devils|vapors|megrims
board|circuit board|add-in|card|plug-in|circuit card
bold|audacious|unafraid|temerarious|rash|overvaliant|foolhardy|daredevil|emboldened|unfearing|overreaching|reckless|adventurous|adventuresome|courageous|heroic|heroical|intrepid|heady|fearless|vaulting|brave|dauntless|forward|nervy
bolt|slap|smack|slapdash|bang
bond|slave|enthralled|in bondage|enslaved
bones|castanets|maraca|finger cymbals|clappers
book|ledger|account book|leger|book of account
boom|windfall|bunc|manna from heaven|gold rush|gravy|godsend|bonanza
boot|rush|flush|charge|thrill|kick|bang
booty|dirty money|pillage|prize|swag|plunder|loot
border|delimitation|boundary line|borderline|mete
boring|irksome|deadening|slow|uninteresting|wearisome|tedious|tiresome|dull|ho-hum
born|given birth|calved|foaled|dropped|hatched|whelped
bother|pain|pain in the ass|botheration|annoyance|pain in the neck|infliction
bottom|nethermost|nether|inferior|lowermost|bottommost
bound|unfree|apprenticed|articled|indentured
brain|mental capacity|wi|brainpower|mentality|learning ability
brass|administration|establishment|organization|organisation|governance|governing body
brave|audacious|intrepid|fearless|unfearing|dauntless|bold
breach|rift|rupture|break|falling out|severance
bread|simoleons|lolly|cabbage|gelt|lettuce|scratch|moolah|kale|boodle|pelf|shekels|sugar|wampu|dinero|dough|loot|clams|lucre
breast|tit|boob|knocker|titty|bosom
breath|breathing place|breathing spell|breathing space|breather|breathing tim
breathing|sweet-breathed|snorting|eupnoeic|eupneic|snoring
bridal|wedding|marriage ceremony|ceremony|observance|ceremonial occasion|nuptial|ceremonial|spousal|marriage
briefly|shortly|concisely|in brief|in short
bright|silvern|shimmery|glinting|silvery|dazzling|blazing|glistering|brilliant|fulgid|opaline|lambent|beadlike|agleam|opalescent|lurid|pearlescent|noctilucent|buttonlike|refulgent|flashing|glimmering|lucent|nitid|glittery|bright as a new penny|beady|iridescent|glistening|scintillant|effulgent|beamy|shiny|silver|aglow|blinding|glossy|buttony|glary|glittering|gleaming|lustrous|twinkling|aglitter|glaring|sheeny|fulgent|coruscant|sparkly|radiant|glimmery|self-luminous|beaming|nacreous|luminous|ardent|scintillating|shining
broad|blanket|all-encompassing|extensive|all-inclusive|across-the-board|wide|all-embracing|panoptic|encompassing|comprehensive
brochure|pamphlet|leaflet|booklet|folder
broke|stone-broke|stony-broke|poor|bust|skint
brunette|dark-haired|tanned|brown|suntanned|brunet|black-haired|dark-skinned|browned|swart|dark|swarthy|nutbrown|bronzed|dusky|grizzled|brown-haired|adust
brutal|barbarous|roughshod|vicious|fell|inhumane|cruel|savage
buck|one dollar bill|clam|dollar|dollar bill
buddy|pal|crony|brother|chum|sidekick
build|physique|figure|anatomy|fles|human body|shape|form|soma|material body|bod|chassis|frame|physical body
burden|gist|core|essence|effect
bureau|agency|government agency|office|federal agency|authority
burning|ablaze|afire|blazing|on fire|lit|lighted|aflame|flaming|alight|aflare
pack|battalion|large number|multitude|plurality
paid|freelance|post-free|square|reply-paid|compensated|remunerated|compensable|mercenary|salaried|stipendiary|postpaid|prepaid|paid-up|paying|remunerative|cashed
pain|pain in the ass|botheration|bother|annoyance|pain in the neck|infliction
painful|torturing|biting|itchy|inhumane|sore|poignant|torturesome|achy|stinging|wrenching|agonizing|tingling|harrowing|galled|racking|saddle-sore|burning|torturous|bitter|raw|agonising|agonized|chafed|agonised|prickling|sensitive|harmful|excruciating|tender|aching|traumatic
palm|decoration|medallion|medal|ribbon|laurel wreath
panel|instrument panel|board|control panel|control board
paradise|Eden|Nirvana|promised land|Shangri-l|heaven
parallel|symmetric|collateral|nonintersecting|nonconvergent|symmetrical|comparable|antiparallel
parent|bring up|raise|nurture|rear
particle|spec|mote|molecule|atom|corpuscle
passing|cursory|careless|perfunctory|casual
passive|unresisting|supine|resistless|inactive|hands-off
password|parole|word|countersign|watchword
past|other|quondam|bypast|gone|ancient|ago|sometime|recent|chivalric|historic|then|erstwhile|departed|former|historical|last|knightly|ult|old|foregone|onetime|early|prehistorical|ultimo|olden|prehistoric|outgoing|bygone|agone|noncurrent|previous|late|medieval
pastor|curate|minister of religion|minister|parson|recto
patent|evident|plain|apparent|obvious|unmistakable|manifest
patient|tolerant|longanimous|patient of|enduring|forbearing|diligent|unhurried|persevering|uncomplaining|long-suffering
payable|due|owed|collectable|collectible
paying|compensable|stipendiary|salaried|paid|remunerative
peaceful|peace-loving|nonbelligerent|quiet|pacifistic|nonviolent|pacific|peaceable|amicable|pacifist|unaggressive|irenic|dovish|halcyon|nonaggressive|undisturbed
peak|acme|elevation|height|summit|superlative|meridian|tiptop|to|pinnacle
pendant|dependent|hanging|supported|hanging down|pendent
perfect|stark|unadulterated|gross|staring|utter|arrant|unmitigated|everlasting|thoroughgoing|sodding|double-dyed|consummate|complete|pure
perhaps|peradventure|maybe|possibly|perchance|mayhap
periodic|cyclic|oscillatory|pulsed|oscillating|periodical|intermittent
peripheral|off-base|circumferential|fringy|skirting|encircling|marginal
person|someone|somebody|mortal|soul|individual
personal|personalised|individualised|private|ad hominem|ain|in the flesh|personalized|individualized|person-to-person|own|in-person|individual|face-to-face
pest|cuss|blighter|gadfly|pesterer
petite|diminutive|lilliputian|flyspeck|little|midget|small|bantam|tiny
petroleum|crude oil|crude|fossil oi|rock oil
pharmacy|apothecary's shop|drugstore|chemist's|chemist's shop
philosophy|doctrine|philosophical system|school of thought|ism
phrase|idiomatic expression|set phrase|phrasal idiom|idiom
physical|physiological|sensual|corporal|physiologic|somatogenetic|somatogenic|corporeal|personal|fleshly|bodily|carnal|somatic|material|animal
physician|doc|MD|medic|doctor|Dr.
picnic|piece of cak|duck soup|pushover|child's play|cinch|walkover|snap|breeze
pike|freeway|superhighway|motorway|throughway|expressway|state highway|thruwa
pill|oral contraceptive|anovulatory drug|contraceptive pill|anovulant|birth control pill|oral contraceptive pill
plain|patent|evident|apparent|obvious|unmistakable|manifest
player|role player|actor|histrion|thespian
plaza|mall|shopping mall|shopping center|center|shopping centr
pleasant|gratifying|pastoral|good-natured|pleasurable|enjoyable|idyllic|pleasing|beautiful|nice|dulcet|grateful
pleased|content|encouraged|amused|delighted|diverted|gratified|contented|chuffed|entertained|bucked up
pointed|acanthoid|five-pointed|sharp|acanthous|tapering|spinous|sharpened|needlelike|nibbed|fusiform|pyramidic|tapered|spikelike|acuate|spindle-shaped|angular|six-pointed|bristle-pointed|barrelled|pyramidal|cigar-shaped|angulate|pyramidical|peaked|acute|spiked|barreled
polar|cold|glacial|arctic|gelid|icy|frigid
polished|shiny|burnished|bright|finished|lustrous|shining
pope|Catholic Pope|Holy Father|pontiff|Roman Catholic Pope|Vicar of Christ|Bishop of Rome
popular|favorite|hot|fashionable|favourite|touristy|best-selling|touristed
portable|take-away|man-portable|movable|takeout
porter|doorkeeper|hall porter|door guard|ostiary|gatekeeper|doorman
positive|affirmative|supportive|constructive|optimistic|affirmatory
possible|come-at-able|attainable|workable|conceivable|thinkable|practical|executable|doable|accomplishable|achievable|manageable|realizable|affirmable|contingent|mathematical|assertable|feasible|likely|practicable|realistic|viable
possibly|peradventure|maybe|perhaps|perchance|mayhap
potato|white potato|murphy|spud|tater|Irish potato
pound|quid|pound sterling|British pound sterling|British pound
powered|hopped-up|high-powered|steam-powered|power-driven|battery-powered|supercharged
powerful|strong|effectual|puissant|coercive|all-powerful|compelling|mighty|muscular|effective|stiff|regent|reigning|omnipotent|efficacious|ruling|potent|regnant|almighty
practical|interoperable|concrete|pragmatical|applicatory|functional|applicable|applied|operable|practicable|serviceable|matter-of-fact|applicative|working|realistic|pragmatic|possible|unimaginative
practice|exercise|drill|recitation|practice session
precious|cherished|wanted|loved|treasured
precise|correct|accurate|exact|right
predict|forecas|prognosticate|presage|bode|betoken|augur|omen|auspicate|prefigure|foretell|portend|foreshadow
preferred|favorite|favourite|favored|preferent|pet|loved|best-loved
pregnant|enceinte|gravid|great|large|heavy|with child|expectant|big
prepare|ready|cook|make|fix
prepared|equipped|oven-ready|precooked|spread|braced|ready|embattled|processed|up|fitted out|preconditioned
prescribed|appointed|decreed|settled|ordained
present|on hand|in attendance|naturally occurring|omnipresent|ubiquitous|attending|ever-present|existing|attendant|here
president|chair|chairman|chairperson|chairwoman
pressure|imperativeness|insistency|pres|insistence
prevent|forbid|forestall|preclude|foreclose
primarily|in the main|mainly|principally|chiefly
prime|superior|select|quality|prize|choice
principal|chief|main|primary|of import|important
priority|precedence|antecedence|precedency|antecedency|anteriority
private|backstage|confidential|close|nonpublic|semiprivate|tete-a-tete|closed-door|snobby|privy|insular|esoteric|one-on-one|reclusive|clubby|offstage|cliquish|head-to-head|secluded|toffee-nosed|snobbish|sequestered|cloistered|personal|secret|clannish
prize|superior|select|quality|choice|prime
proceeds|payof|issue|return|yield|take|takings
process|cognitive process|cognitive operation|mental process|operation
processed|cured|clarified|finished|semi-processed|vulcanised|computerized|vulcanized|polished|milled|treated|computerised|pure
processor|central processing unit|central processor|CPU|mainframe|C.P.U.
productive|tillable|fur-bearing|amentaceous|profitable|amentiferous|fecund|nut-bearing|creative|rich|successful|oil-bearing|cultivable|cultivatable|arable|fertile|bearing|fruitful|originative|prolific
profits|profit|net profit|net|earnings|net income|lucre
projected|protrusive|sticking|protruding|jutting|sticking out|projecting
promote|boost|further|encourage|advance
proper|strait-laced|fitting|right|correct|prissy|decent|puritanical|comme il faut|straitlaced|comely|halal|seemly|tight-laced|becoming|straightlaced|prudish|prim|kosher|victorian|decorous|priggish|straight-laced|square-toed|appropriate
prophet|oracle|seer|vaticinator|prophesier
prostate|endocrine gland|endocrine|prostatic|ductless gland
protective|safety-related|custodial|conserving|defensive|prophylactic|preserving|guardian|tutelar|contraceptive|protecting|tutelary|restrictive|preventative|preservative|antifertility|antifouling|cautionary|preventive|evasive|overprotective
proud|prideful|uppish|self-respectful|swollen-headed|braggy|haughty|supercilious|big|persnickety|braggart|dignified|respected|self-important|redoubtable|vainglorious|too big for one's breeches|swaggering|pleased|swelled|self-aggrandizing|crowing|egotistic|sniffy|self-conceited|chesty|purse-proud|self-respecting|snotty|illustrious|gratifying|disdainful|bigheaded|self-aggrandising|overproud|immodest|glorious|stuck-up|boastful|swollen|snot-nosed|proud of|arrogant|bragging|cock-a-hoop|beaming|shabby-genteel|conceited|vain|snooty|lordly|egotistical|house-proud
prove|shew|establish|demonstrate|show
proved|well-tried|proven|evidenced|established|tested|tried|verified
proven|well-tried|proved|evidenced|established|tested|tried|verified
provisions|commissariat|viands|provender|victuals
publish|bring out|release|issue|put out
punch|lick|poke|clout|bif
punk|crummy|bum|chintzy|cheesy|sleazy|tinny|inferior|cheap
pure|stark|unadulterated|gross|perfect|staring|utter|arrant|unmitigated|everlasting|thoroughgoing|sodding|double-dyed|consummate|complete
purple|over-embellished|embellished|empurpled|rhetorical
pursuit|spare-time activity|avocation|hobby|sideline|by-line
quality|superior|select|prize|prime|choice
quarter|stern|after part|poop|tail
queen|pansy|poove|nance|fag|fagot|fairy|pou|queer|faggot|poof
query|question|inquiry|enquiry|interrogation
quick|spry|agile|nimble|active
quiet|soft|subdued|hushed|muted
racial|interracial|racist|multiracial|biracial
rage|cult|craze|fad|furore|furor
railway|railroad|railway line|railway syste|railroad line
raise|acclivity|rise|ascent|upgrade|climb
raised|adorned|decorated|brocaded|embossed
random|stochastic|haphazard|hit-or-miss|ergodic
randy|sexy|turned on|steamy|horny|aroused|ruttish
rank|downright|right-down|out-and-out|absolute|complete|sheer
ranked|graded|hierarchal|hierarchic|hierarchical|stratified
rapidly|chop-chop|speedily|apace|quickly
rational|sane|reasoning|demythologized|coherent|thinking|sensible|demythologised|lucid|logical|intelligent|reasonable
ready|waiting|ripe|prepared|prompt|set|at the ready|ready and waiting|willing|fit|in order|primed
real|true|genuine|literal|actual
realistic|lifelike|down-to-earth|living|vivid|pictorial|graphic|virtual|real|true-to-life|hardheaded|hard-nosed|veridical|pragmatic|existent|true to life|practical|possible|earthy
realize|earn|take in|pull in|gain|realise|clear|make|bring i
realized|complete|accomplished|completed|realised
realtor|land agent|real estate broker|real estate agent|estate agent|house agen
reasonably|within reason|fairly|moderately|somewhat|middling|passably
receive|undergo|experience|get|have
recently|of late|latterly|lately|late
recorded|canned|transcribed|tape-recorded|filmed|taped|prerecorded
reduce|cut|contract|foreshorten|abbreviate|abridge|shorten
reduced|decreased|bated|cut|slashed|attenuated|minimized|shriveled|remittent|belittled|faded|diminished|small|attenuate|shrunken|shrivelled|ablated|weakened
refined|debonair|twee|debonaire|elegant|cultured|overrefined|polite|well-mannered|polished|fastidious|well-bred|niminy-piminy|civilised|dainty|mincing|delicate|gentlemanly|suave|ladylike|prim|cultivated|debonnaire|superfine|couth|genteel|gracious|finespun|gentlemanlike|civilized
reflect|chew over|think over|muse|mull|mull over|speculat|excogitate|meditate|contemplate|ruminate|ponder
reflection|thoughtfulness|rumination|musing|contemplation|reflexion
regardless|unheeding|careless|thoughtless|heedless
registered|qualified|enrolled|recorded|certified|listed
regular|uniform|rule-governed|day-after-day|prescribed|weak|well-ordered|rhythmic|symmetric|stock|lawful|systematic|day-to-day|official|nightly|routine|timed|regularized|first-string|rhythmical|symmetrical|standard|orderly|regularised|every day|daily
relate|associate|colligate|connect|link|tie in|link up
related|affinal|agnatic|consanguine|consanguineal|blood-related|direct|collateral|enatic|kin|kindred|allied|agnate|cognate|consanguineous|maternal|indirect|lineal|akin|paternal|affine|enate
relevant|applicable|pertinent|to the point|in dispute|germane|at issue|in question|related|under consideration|in hand
religious|pious|churchly|devout|churchgoing|churchlike|god-fearing|interfaith
remainder|residue|balance|residuum|residual|rest
remaining|left over|left|unexpended|odd|leftover|unexhausted
remains|clay|stiff|corpse|cadaver
repair|reparation|mend|fixing|fixture|fix|mending
reserved|indrawn|undemonstrative|aloof|diffident|distant|backward|restrained|withdrawn|inhibited|upstage
resistance|electrical resistance|electric resistance|resistivity|ohmic resistanc|impedance
resolve|resoluteness|firmness of purpose|firmness|resolution
resort|hangout|repair|haunt|stamping ground
respected|illustrious|glorious|proud|redoubtable
respective|several|various|single|individual
restricted|out-of-bounds|circumscribed|unfree|off-limits|closed|limited|classified|confined
result|outcome|issue|event|effect|consequence|upshot
resulting|subsequent|consequent|ensuant|sequent|resultant
retain|keep on|keep goin|keep|continue
ribbon|decoration|medallion|medal|palm|laurel wreath
rich|privileged|well-situated|easy|well-off|flush|abundant|well-fixed|affluent|well-heeled|wealthy|moneyed|prosperous|loaded|comfortable|well-to-do
right|reactionist|rightist|reactionary|conservative|rightish|right-wing|far-right
risk|hazard|endangerment|jeopardy|peril
road|moving|touring|itinerant|traveling
robust|strong|husky|square-shouldered|broad-shouldered|hardy|healthy|buirdly|big-chested|sturdy|vigorous|iron|stalwart|heavy-armed|chesty|big-shouldered|square-built|cast-iron|strapping|burly|beefy|big-boned|stout|rugged
rocky|bouldery|stony|bouldered|rough|unsmooth
role|theatrical role|persona|part|character
root|ascendant|ancestor|ascendent|antecedent
rope|forget me drug|circl|Mexican valium|R-2|rophy|roach|roofy
rough|unsubdivided|fringed|dentate|simple|bidentate|compound|fimbriate|biserrate|serrated|denticulate|serrulate|spinose|lacerate|saw-toothed|scalloped|notched|crenulate|crispate|toothed|ciliate|jagged|laciniate|pectinate|emarginate|erose|crenate|angulate|crenated|runcinate|jaggy|serrate|rimose|ciliated|crenulated|lacerated
roughly|about|or s|more or less|some|approximately|around|just about|close to
round|cumuliform|apple-shaped|spheric|capitate|discoid|globular|disclike|pear-shaped|disklike|moon-round|bulb-shaped|disc-shaped|ball-shaped|roundish|bulbous|rounded|global|wheel-like|nutlike|spherical|discoidal|circular|barrel-shaped|pinwheel-shaped|orbicular|goblet-shaped|ringlike|bulblike|pancake-like|globose|coccoid|disk-shaped|moonlike
routine|quotidian|mundane|ordinary|everyday|workaday|unremarkable
ruby|red|reddish|cerise|cherry-red|crimson|cherry|chromatic|ruddy|carmine|blood-red|scarlet|ruby-red
rule|convention|pattern|formula|normal
rural|country-bred|arcadian|pastoral|agrestic|countryfied|rustic|bucolic|campestral|agricultural|homespun|countrified|country-style|farming|cracker-barrel|hobnailed|folksy|agrarian
calm|content|placid|contented|easygoing
campaign|cause|movement|drive|effort|crusade
careful|blow-by-blow|elaborated|certain|close|minute|narrow|elaborate|cautious|scrupulous|painstaking|particular|too-careful|detailed|thorough|protective|overcareful|conscientious|prudent|studious|sure|diligent
cargo|payload|load|shipment|consignment|freight|lading|loading
caring|fond|lovesome|affectionate|loving|tender|warm
catch|pinch|collar|taking into custody|arrest|apprehension
cattle|kine|Bos taurus|cows|oxen
cause|movement|drive|campaign|effort|crusade
cellular|faveolate|multicellular|cell-like|pitted|cancellate|cavitied|lymphoblast-like|honeycombed|cancellous|alveolate|cancellated
cemetery|graveyard|burial site|burying ground|necropolis|memorial park|burial ground
central|midway|centrical|bifocal|center|nuclear|bicentric|centered|centric|midmost|medial|halfway|middle|focal|amidship|middlemost|median
centre|heart|middle|center|eye
century|100|one C|centred|C|hundred
certainly|surely|sure enough|for sure|sure|for certain|sure as shooting
chairman|chair|chairperson|chairwoman|president
charitable|philanthropic|beneficent|generous|eleemosynary|benevolent
charming|wizardly|magical|sorcerous|witching|wizard|supernatural|magic
chassis|physique|figure|anatomy|human body|shape|form|soma|material body|bod|build|frame|flesh|physical body
chat|schmoose|confab|confabulation|schmooze
cheap|meretricious|tawdry|tasteless|gimcrack|brassy|gaudy|tatty|garish|tacky|flash|flashy|loud|trashy
check|stop|hitch|halt|stay|arrest|stoppage
cherry|red|reddish|cerise|cherry-red|ruby|crimson|chromatic|ruddy|carmine|blood-red|scarlet|ruby-red
chevy|harry|chevvy|harass|hassle|chivvy|molest|provoke|chivy|plague|beset
chicken|yellow|chickenhearted|fearful|lily-livered|yellow-bellied|cowardly|white-livered
chief|main|principal|primary|important|of import
chile|chili pepper|chili|chilly|chilli
chip|fleck|flake|bit|scrap
choice|superior|select|quality|prize|prime
chubby|zaftig|zoftig|embonpoint|plump|fat|buxom
cigarette|cigaret|fag|butt|coffin nail
circular|ringed|rounded|annulated|annular|doughnut-shaped|circinate|ring-shaped|annulate
citation|credit|reference|acknowledgment|mention|cite|quotation
cite|credit|reference|acknowledgment|citation|mention|quotation
clan|kin group|kinship group|tribe|kin|kindred
classified|categorized|sorted|categorised|grouped
clay|stiff|corpse|cadaver|remains
clear|innocent|exonerated|absolved|cleared|clean-handed|guiltless|exculpated|vindicated
cleared|innocent|exonerated|absolved|clean-handed|guiltless|exculpated|clear|vindicated
climb|acclivity|rise|raise|ascent|upgrade
clocks|alfilaria|redstem storksbill|filaria|alfileria|pin grass|pin clover|Erodium cicutarium|filaree
close|surrounding|next|close-hauled|impendent|juxtaposed|at hand|enveloping|circumferent|close together|impending|nestled|snuggled|adpressed|ambient|close-set|immediate|hand-to-hand|close set|walking|close at hand|appressed|proximate|scalelike|side by side|adjacent|contiguous|walk-to|imminent|approximate|encompassing
closing|terminative|year-end|terminal|final|last|concluding
closure|stop|blockage|block|occlusion|stoppage
clothing|wearable|habiliment|article of clothing|wear|vesture
cloudy|smoggy|sullen|misty|grey|vapourous|gray|cloudlike|dull|nebular|hazy|foggy|vaporous|miasmic|miasmal|leaden|threatening|brumous|overcast|lowering|clouded|heavy|sunless|cloud-covered
coach|charabanc|passenger vehicle|motorcoach|jitney|autobus|motorbus|double-decker|omnibus|bus
coastal|maritime|coastwise|inshore|seaward
coated|black-coated|backed|oily|glazed
coffee|deep brown|chocolate|burnt umber|umber
cold|refrigerant|rimed|cutting|algid|unwarmed|bleak|frore|cool|refrigerated|glacial|acold|stone-cold|polar|frozen|arctic|ice-cold|nippy|icy|nipping|crisp|rimy|raw|frigorific|parky|shivery|unheated|gelid|snappy|refrigerating|frosty|frigid|heatless
cole|Brassica oleracea acephala|kale|colewort|borecole|kail
collar|pinch|catch|taking into custody|arrest|apprehension
collected|amassed|assembled|congregate|concentrated|accumulated|massed
collective|assembled|agglomerative|collectivized|aggregate|agglomerate|made-up|mass|built|integrative|collectivised|joint|united|clustered|aggregative|agglomerated|knockdown|aggregated
colored|slanted|partial|biased|coloured|one-sided|unfair
combined|compounded|one|sorbed|rolled into one|composed|conglomerate|hyphenated|occluded
come|seminal fluid|semen|ejaculate|seed
comic|mirthful|risible|humorous|amusing|comical|laughable|humourous|funny
coming|upcoming|approaching|forthcoming|future
commercial|commercialised|mercenary|commercialized|technical|mercantile|moneymaking
commit|intrust|confide|trust|entrust
committed|intended|bespoken|involved|betrothed|attached|pledged|engaged|loving|affianced
common|general|grassroots|frequent|ordinary|democratic|usual|average|standard|demotic|popular
commonly|ordinarily|normally|unremarkably|usually
communist|political theory|political orientation|ideology|communistic
compact|consolidated|dough-like|clayey|concentrated|tight|clay-like|heavy|wedged|serried|cloggy|close-packed|impacted|packed
comparable|parallel|equal|comparable with|comparable to
compatible|congruous|harmonious|congenial|matched
competent|qualified|skilled|efficient|able|capable|effective|workmanlike
complete|hearty|right-down|full-clad|full-dress|self-contained|full-scale|total|dead|all-out|accomplished|all|absolute|thoroughgoing|realized|sound|full-blown|rank|sheer|fleshed out|clean|thorough|exhaustive|good|realised|downright|all-or-nothing|out-and-out|completed|whole|stand-alone|allover|full|all-or-none|comprehensive
completed|accomplished|complete|realized|realised
completely|altogether|all|wholly|whole|totally|entirely
completion|culmination|closing|windup|mop up
complex|multiplex|convoluted|intricate|tortuous|compound|multifactorial|labyrinthian|tangled|Byzantine|interlacing|knotty|interwoven|difficult|interlinking|hard|thickening|daedal|labyrinthine|Gordian|colonial|decomposable|complicated|involved|interlocking|mazy|analyzable|composite
compliant|manageable|obedient|amenable|nonresistant|conformable|manipulable|willing|lamblike|tractable
component|ingredient|element|factor|constituent
composed|self-collected|unflappable|tranquil|calm|serene|equanimous|poised|unflustered|collected|unperturbed|unagitated|unflurried|self-contained|unruffled|imperturbable|nerveless|cool|self-possessed|coolheaded|dignified
compound|pinnatifid|trilobated|three-lobed|palmate|even-pinnate|bipinnatifid|pinnate|trifoliolate|trifoliated|tripinnated|abruptly-pinnate|lobate|tripinnate|palm-shaped|trifoliate|incised|paripinnate|smooth|palmatifid|bipartite|parted|complex|pinnatisect|tripinnatifid|conjugate|ternate|lobed|rough|bilobate|imparipinnate|trilobate|bilobated|quinquefoliate|decompound|binate|pinnated|bilobed|dissected|cleft|odd-pinnate|pedate|bipinnate|trilobed
compute|figure out|figure|calculate|cipher|work out|reckon|cypher
computer|estimator|reckoner|figurer|calculator
concern|business|business organisation|business concern|business organization
concerned|afraid|troubled|haunted|obsessed|taken up|solicitous|attentive|preoccupied
concluded|ended|finished|terminated|over|all over|complete
concrete|factual|touchable|objective|real|existent|tangible|practical
confidence|self-confidence|sureness|assurance|authority|self-assurance
confident|self-confident|assured|overconfident|positive|self-assured|cocksure|reassured
confused|addled|addlepated|stupid|wooly-minded|stupefied|wooly|befuddled|stunned|dazzled|silly|muddled|addlebrained|muzzy|punch-drunk|muddleheaded|puddingheaded|perplexed|slaphappy|spaced-out|clouded|befogged|woolly|dazed|trancelike|potty|woolly-headed
connect|associate|colligate|link|tie in|link up|relate
connected|well-connected|neighboring|affined|joined|engaged|siamese|contiguous|attached|conterminous|linked|socially connected|adjunctive|adjacent|coupled|adjoining|abutting
connector|connection|connective|connecter|connexion
conscious|aware|alert|cognizant|awake|sensible|sensitive|self-conscious|semiconscious|voluntary|self-aware|sentient|cognisant
consistent|unchanging|invariable|conformable|consonant|agreeable|reconciled|self-consistent|pursuant|concordant|accordant
constant|continuous|never-ending|incessant|ceaseless|unremitting|unceasing|perpetual|uninterrupted
content|satisfied|complacent|self-complacent|calm|easygoing|happy|pleased|self-satisfied|placid|contented|smug
controlled|pressurised|regimented|pressurized|dominated|restrained|obsessed|possessed|priest-ridden|price-controlled|harnessed|contained|disciplined
convinced|confident|positive|sure|certain
cooked|rare-roasted|parched|sauteed|burned|seared|ready-cooked|au gratin|fried|roasted|roast|grilled|pancake-style|hard-boiled|poached|lyonnaise|braised|candy-like|done|deep-fried|baked|steamed|burnt|wafer-like|boiled|hard-baked|saute|well-done|medium|stewed|soft-boiled|batter-fried|barbecued|toasted|broiled|souffle-like|overdone|sunny-side up
cool|air-cooled|cold|precooled|air-conditioned|caller|water-cooled|chilly|chill
copper|fuzz|bull|cop|pig
corporate|corporal|bodied|embodied|corporeal|incarnate|material
correct|word-perfect|letter-perfect|right|precise|exact|true|accurate|proper|straight
counsel|counselor|counsellor|counselor-at-law|pleader|advocate
counseling|counselling|counsel|guidance|direction
count|enumeration|tally|numeration|reckoning|counting
counting|enumeration|tally|numeration|reckoning|count
covered|ariled|crusty|overgrown|snow-covered|sealed|canopied|dabbled|draped|moon-splashed|blanketed|white|splattered|drenched|plastered|wrapped|peritrichous|tiled|beaded|thickspread|spattered|muffled|mossy|crusted|barnacled|moss-grown|crustlike|mantled|encrusted|clothed|snow-clad|sun-drenched|smothered|splashy|splashed|cloaked|arillate|mud-beplastered|snowy|drenched in|awninged
crack|super|topnotch|fantastic|A-one|superior|first-rate|tiptop|tops|ace
craft|craftiness|wiliness|foxiness|guile|cunning|slyness
crash|clash|clangor|clank|clangour|clang|clangoring
crazy|insane|mad|disturbed|unbalanced|distracted|sick|unhinged|brainsick|demented
creature|animate being|fauna|beast|brute|animal
criminal|wrong|deplorable|reprehensible|vicious|condemnable
critical|dire|desperate|crucial|acute|important|grievous|severe|grave|dangerous|serious|life-threatening
cross|ill-tempered|grouchy|bad-tempered|fussy|crabbed|ill-natured|grumpy|crabby
crucial|essential|all important|important|of import|of the essence|all-important
cubic|box-shaped|cubelike|boxlike|cuboid|cube-shaped|three-dimensional|cubical|blocky|cubiform|isometric|boxy|solid|blockish|cuboidal|brick-shaped
curious|rummy|peculiar|unusual|singular|odd|queer|strange|rum|funny
current|modern|present-day|rife|topical|underway|up-to-the-minute|actual|circulating|ongoing|on-line|incumbent|new|latest|prevailing|live|up-to-date|contemporary|on-going|prevalent|afoot|occurrent
curriculum|programme|program|syllabus|course of study
custom|custom-made|bespoken|customized|custom-built|tailor-made|customised|bespoke|made-to-order|tailored
customized|custom-made|bespoken|custom-built|tailor-made|customised|bespoke|custom|made-to-order|tailored
daddy|pappa|dad|dada|papa|pop|pa
daily|day-to-day|every day|regular|day-after-day
damaged|dilapidated|peeling|broken|injured|defaced|blemished|busted|bent|impaired|destroyed|scraped|mangled|mutilated|derelict|bedraggled|hurt|marred|knocked-out|storm-beaten|battered|scorched|trampled|dented|crumpled|riddled|weakened|broken-backed|beat-up|broken-down|tumble-down|trodden|ramshackle|tatterdemalion|ruptured|scratched|burst|beaten-up
damages|amends|restitution|indemnification|indemnity|redress
dame|skirt|chick|bird|wench|doll
dangerous|critical|grievous|severe|grave|serious|life-threatening
dark|glooming|lightless|unlighted|Cimmerian|crepuscular|unlit|pitch-black|darkening|aphotic|dim|gloomy|twilit|pitch-dark|sulky|gloomful|darkened|black|Acheronian|twilight|darkling|caliginous|subdued|unilluminated|semidark|tenebrific|Acherontic|dusky|tenebrious|tenebrous|Stygian
dawn|sunup|morning|break of the day|dayspring|sunrise|first light|break of day|cockcrow|aurora|dawning|daybreak
dead|bushed|tired|all in|beat
deadly|pernicious|noxious|harmful|baneful|pestilent
deaf|profoundly deaf|hard-of-hearing|deafened|deaf as a post|deaf-mute|stone-deaf|hearing-impaired|tone-deaf|deaf-and-dumb|unhearing
debut|unveiling|launching|introduction|first appearance|entry
declared|alleged|announced|proclaimed|avowed|professed|asserted
decreased|bated|cut|slashed|attenuated|minimized|shriveled|remittent|belittled|faded|diminished|small|attenuate|reduced|shrunken|shrivelled|ablated|weakened
dedicated|sacred|holy|consecrate|consecrated|ordained|votive
defensive|protective|antisubmarine|en garde|antiaircraft|defending|antitank
defined|circumscribed|characterized|characterised|delimited|definite
definitely|unquestionably|decidedly|in spades|emphatically|by all odds
delay|hold|postponement|wait|time lag
delayed|delayed-action|slow|held up|deferred|abeyant|postponed|suspended
delegation|relegating|delegating|relegation|deputation
delicious|scrumptious|pleasant-tasting|luscious|toothsome|yummy|tasty|delectable
demanding|strict|difficult|exacting|tight|rigorous|hard|hard-to-please|tightened|hard to please|stringent|stern|exigent|needy
democratic|advocator|exponent|proponent|advocate
denial|self-renunciation|self-denial|abnegation|self-abnegation
density|concentration|tightness|denseness|compactness
dependence|dependency|habituation|addiction|dependance
dependent|symbiotic|babelike|unfree|helpless|mutualist|myrmecophilous|bloodsucking|underage|reliant|parasitic|interdependent|parasitical|leechlike|mutually beneficial
depot|storage|entrepot|storehouse|store
derby|bowler|plug hat|derby hat|bowler hat
derived|plagiarized|derivable|copied|traced|derivative|plagiaristic|plagiarised
descending|down|descendent|downward-sloping|falling|raining|declivitous|drizzling|dropping|downhill|degressive|downward|downward-arching|descendant
desert|inhospitable|waste|godforsaken|wild
desirable|enviable|sought after|preferred|coveted|wanted|loveable|preferable|lovable|in demand|sexually attractive|plummy|delectable|desired
desired|sought after|desirable|coveted|in demand
destroyed|wiped out|demolished|burned-over|extinguished|broken|burned|gone|sacked|ruined|obliterated|wrecked|burned-out|finished|done for|pillaged|obliterate|war-torn|war-worn|totaled|kaput|burnt|annihilated|scorched|exterminated|burnt-out|fallen|impoverished|dismantled|blighted|shattered|damaged|spoilt|tattered|despoiled|ravaged|raped|razed|blotted out
detect|observe|notice|find|discover
detection|espial|spying|catching|spotting
determine|find out|check|ascertain|learn|watch|see
developed|mature|formulated|formed|matured
directive|directional|guiding|leading|directing
dirty|scabrous|filthy|obscene|foul-mouthed|bawdy|blue|ribald|foul-spoken|dirty-minded|salacious|smutty|nasty|scatological|foul|blasphemous|indecent|profane|raunchy|off-color|lewd
disaster|tragedy|catastrophe|calamity|cataclysm
discharge|dismission|sack|liberation|sacking|firing|release|dismissal
discover|observe|notice|find|detect
distinct|outlined|chiseled|clean-cut|sharp|knifelike|razor-sharp|precise|well-defined|defined|clear-cut|clear|crystalline|definite|crisp
distribute|mete out|lot|dispense|administer|parcel out|deal out|shell out|dish out|allot|dole out|deal
disturbed|insane|mad|unbalanced|distracted|crazy|sick|unhinged|brainsick|demented
divided|fork-like|segregated|tined|disconnected|trifid|biloculate|bicameral|disunited|apart|cloven|bisulcate|torn|bilocular|metameric|branched|pentamerous|mullioned|subdivided|unintegrated|black-and-white|chambered|separate|disjointed|bifurcate|prongy|many-chambered|in disagreement|partitioned off|dichotomous|biramous|separated|bifid|forficate|segmental|disjunct|distributive|four-pronged|forked|three-pronged|partitioned|two-chambered|sectioned|split|pronged|sectional|cleft|episodic|segmented|two-pronged|fragmented|bifurcated
doctor|physician|doc|MD|medico|Dr.
doctrine|philosophy|philosophical system|school of thought|ism
documented|echt|attested|genuine|authenticated
doll|skirt|chick|bird|dame|wench
dome|bonce|bean|attic|noodle|noggin
dominant|ascendant|dominating|preponderant|predominant|predominate|ascendent|paramount|sovereign|superior|possessive|overriding|controlling|supreme|governing|preponderating
dose|battery-acid|Lucy in the sky with diamonds|superman|window pane|loony toons|back breaker|Elvis|acid|dot|pane|Zen
down|descending|behind|set|downbound|thrown|weak|fallen|downward|downfield|downcast|low
dozen|cardinal|12|twelve|xii
dozens|slews|wads|heaps|gobs|oodles|tons|mountain|scores|loads|scads|lashings|piles|lots|rafts|stacks
drawn|worn|careworn|raddled|haggard|tired
dressed|garmented|appareled|clothed|habilimented|clad|robed|attired|garbed
drill|practice session|exercise|recitation|practice
drinking|boozing|drunkenness|crapulence|drink
drive|cause|movement|campaign|effort|crusade
drunk|drugged|pixilated|squiffy|hopped-up|inebriated|bacchanalian|drunken|blind drunk|sottish|sloshed|cockeyed|fuddled|smashed|sozzled|plastered|doped|stiff|pie-eyed|narcotised|boozy|crocked|bacchanal|orgiastic|beery|slopped|wet|carousing|narcotized|high|soused|bibulous|stoned|intoxicated|bacchic|pissed|tight|half-seas-over|besotted|tipsy|soaked|mellow|tiddley|loaded|blotto|tiddly|potty
dude|beau|sheik|fashion plate|swell|fop|dandy|gallant|clotheshorse
dumb|dense|stupid|slow|dim|dull|obtuse
duplicate|twin|twinned|matching|matched
durable|indestructible|perdurable|undestroyable|imperishable
dust|junk|rubble|detritus|debris
early|first|archean|primaeval|primal|premature|azoic|earlyish|earlier|advance|wee|archaeozoic|archaean|primeval|beforehand|aboriginal|archeozoic|proto|previous|untimely|primordial|proterozoic|earliest
earn|realize|take in|pull in|bring in|gain|realise|clear|make
earnings|profit|net profit|net|profits|net income|lucre
east|eastern|eastbound|eastmost|eastward|eastside|easternmost|easterly
effect|outcome|issue|result|event|consequence|upshot
efficient|effectual|economic|cost-effective|prompt|cost-efficient|timesaving|effective|expeditious|economical|competent|underspent|efficacious|high-octane|businesslike|streamlined
effort|attempt|try|endeavor|endeavour
elderly|aged|senior|old|older
electoral|pick|selection|option|choice
elegant|soigne|fine|high-toned|exquisite|refined|foppish|sophisticated|de luxe|dandified|dandyish|graceful|ritzy|soignee|neat|high-class|luxe|tasteful|recherche|deluxe|dignified
elevation|acme|height|summit|superlative|peak|top|meridian|tiptop|pinnacle
eligible|qualified|bailable|suitable|pensionable|desirable|entitled|in line|worthy|legal
eliminate|extinguish|wipe out|decimate|carry off|annihilate|eradicate
emotional|mind-blowing|affectional|little|lyrical|emotive|maudlin|drippy|funky|releasing|soppy|cathartic|schmalzy|moved|bathetic|affective|charged|overemotional|slushy|soulful|warm-toned|schmaltzy|touched|mawkish|warm|soupy|mushy|sloppy|het up|hot-blooded|moving|temperamental|affected|supercharged|low-down|lyric|hokey|moody|passionate|stirred|Latin|sentimental
empirical|experimental|trial-and-error|experiential|falsifiable|existential|empiric|a posteriori|verifiable|semiempirical|confirmable|observational|data-based
employed|engaged|working|hired|on the job|busy
empty|plundered|empty-handed|looted|vacuous|blank|innocent|clean|stripped|devoid|pillaged|destitute|barren|lifeless|white|bare|ransacked|void|glassy|vacant|glazed
enclosed|embowered|capsulated|enveloped|coarctate|fogbound|encircled|self-enclosed|boxed in|closed in|confined|fencelike|boxed|closed|basined|included|boxed-in|fenced|embedded|enwrapped|capsulate|involved|engulfed|surrounded|besieged|clathrate|fenced in|swallowed|penned
ended|concluded|finished|terminated|over|all over|complete
energy|vim|vigor|vigour|muscularity
engaged|bespoken|betrothed|attached|committed|pledged|affianced
enjoy|bask|savor|relish|savour
ensure|assure|guarantee|insure|secure
entirely|exclusively|alone|solely|only
equal|isometrical|level|equalized|close|isochronous|isoclinal|tantamount|coordinate|balanced|coequal|equalised|even|equivalent|isometric|half-and-half|isoclinic|equidistant|tied|tight|same|equilateral|fifty-fifty|isochronal|comparable|commensurate|quits|isothermal
equipped|panoplied|outfitted|equipt|prepared|accoutred|visored|transistorized|helmeted|accoutered|transistorised|armored
erotica|porno|porn|pornography|smut
essence|gist|core|effect|burden
essential|all important|crucial|important|of import|of the essence|all-important
eternal|lasting|aeonian|ageless|eonian|unceasing|perpetual|unending|everlasting|permanent
ethical|moral|right|honourable|honorable
evaluate|appraise|value|assess|measure|valuate
evident|patent|plain|apparent|obvious|unmistakable|manifest
evil|satanic|diabolical|wretched|mephistophelean|despicable|heinous|bad|pestiferous|sinister|offensive|unholy|infernal|monstrous|flagitious|demonic|wicked|wrong|corruptive|perversive|diabolic|fiendish|mephistophelian|worthless|unrighteous|black|dark|vile|evil-minded|devilish|unworthy|hellish|grievous|ugly|atrocious|immoral|slimy
exact|correct|precise|accurate|right
examine|study|canvas|analyse|canvass|analyze
exceed|outperform|surpass|outstrip|surmount|outgo|outmatch|outdo
excess|supererogatory|unnecessary|surplus|supernumerary|spare|superfluous|extra|redundant|unneeded
excessive|exuberant|overweening|unrestrained|extravagant
excitement|turmoil|upheaval|agitation|hullabaloo
exciting|tickling|exhilarating|electric|stimulating|glamourous|tingling|galvanizing|intoxicating|titillating|galvanic|thrilling|galvanising|breathtaking|breathless|glamorous|elating|electrifying|heady|provocative|interesting|sexy
exclusive|only|privileged|inner|alone|white-shoe|inside|selective
execute|fulfill|accomplish|carry through|carry out|action|fulfil
existing|alive|extant|active|existent
expand|prosper|get ahead|boom|thrive|flourish
expanded|swollen|dilated|distended|enlarged
expected|hoped-for|awaited|matter-of-course|due|anticipated|predicted|unsurprising|foreseen|foretold|supposed|expectable
expensive|overpriced|pricy|costly|valuable|big-ticket|dearly-won|high-ticket|high-priced|dear|pricey
expert|skilled|skilful|practiced|good|proficient|skillful|adept
expressed|overt|express|hard-core|denotive|stated|unambiguous|graphic|hardcore|open|univocal|unequivocal|definitive|denotative|declared|definite|explicit
extended|protracted|prolonged|drawn-out|long|lengthy
extensive|blanket|all-encompassing|all-inclusive|broad|across-the-board|wide|all-embracing|panoptic|encompassing|comprehensive
exterior|out-of-door|outside|outdoor|out
eyed|ox-eyed|saucer-eyed|eyelike|purple-eyed|round-eyed|skew-eyed|almond-eyed|blue-eyed|sharp-eyed|one-eyed|popeyed|keen-eyed|left-eyed|right-eyed
keen|piercing|perceptive|sharp|penetrative|discriminating|acute|incisive|penetrating|knifelike
kick|rush|flush|thril|charge|boot|bang
kind|large-hearted|kind-hearted|charitable|benignant|gracious|kindly|gentle|good-hearted|kindhearted|sympathetic|considerate|good-natured|soft|merciful|openhearted|benign|benevolent
king|mogul|magnate|big businessman|tycoo|top executive|power|business leader|baron
kissing|caressing|smooching|petting|cuddling|hugging|snuggling|fondling|necking
knee|genu|knee joint|human knee|articulatio genus
knock|bang|belt|smash|bash
known|identified|proverbial|illustrious|celebrated|noted|well-known|renowned|famed|familiar|famous|notable|glorious|better-known|best-known|legendary|far-famed|acknowledged
laboratory|science lab|lab|research laboratory|science laborator|research lab
lady|gentlewoman|madam|ma'am|dame
large|extensive|great|puffy|king-size|jumbo|life-sized|monolithic|man-sized|epic|immense|gargantuan|astronomic|cosmic|blown-up|oversize|largish|larger-than-life|tremendous|rangy|sizeable|massive|titanic|enlarged|monstrous|mammoth|astronomical|too large|double|queen-sized|queen-size|large-scale|large-mouthed|enormous|broad|monumental|overlarge|spacious|gigantic|whacking|life-size|elephantine|wide|huge|walloping|stupendous|super|bouffant|grand|colossal|humongous|whopping|capacious|outsize|full-size|mountainous|deep|heroic|ample|Brobdingnagian|prodigious|hulky|voluminous|larger|thumping|plumping|volumed|medium-large|hulking|big|galactic|banging|sizable|biggish|extended|oversized|giant|macro|bulky|outsized|wide-ranging|lifesize|vast|bear-sized|bigger|king-sized
last|antepenultimate|subterminal|sunset|parting|endmost|terminal|fourth-year|senior|parthian|ultimate|next-to-last|penultimate
lasting|long-lasting|long-lived|long|durable
late|ripe|latish|advanced|posthumous|after-hours
lately|of late|latterly|recently|late
latest|fashionable|stylish|in style|modish|in vogue|a la mode
laugh|gag|joke|jest|jap
lawsuit|causa|cause|case|suit
lazy|work-shy|otiose|slothful|idle|indolent|faineant
learn|find out|determine|check|ascertain|watch|see
left|socialistic|far left|liberal|socialist|left-of-center|leftist|leftish|left-wing
legal|accumulation|collection|aggregation|assemblage
liberal|bountiful|bighearted|bounteous|handsome|giving|generous|freehanded|openhanded|big
licensed|authorized|licenced|accredited|authorised|commissioned
licking|trouncing|drubbing|whackin|thrashing|beating|lacing
light|fluorescent|floodlighted|lamplit|candescent|lit|incandescent|lighted|candent|white|lighting-up|autofluorescent|ablaze|luminescent|bioluminescent|livid|sunstruck|floodlit|well-lighted|illuminating|illuminated|inflamed|phosphorescent|sunlit|reddened|bright
lighting|kindling|firing|inflammation|ignition
likely|liable|probable|promising|possible|apt
limiting|constrictive|restricting|confining|restrictive|constraining
liquid|fluent|graceful|fluid|smooth
lite|light|fat-free|fatless|nonfat|low-cal|calorie-free
live|alive|vital|animate|viable|liveborn
liver|colored|colorful|coloured|liver-colored
load|onus|incumbrance|encumbrance|burden
loaded|flush|rich|affluent|wealthy|moneyed
loading|payload|load|shipment|cargo|freight|lading|consignment
loads|slews|wads|heaps|gobs|lashing|oodles|tons|dozens|mountain|scores|scads|piles|lots|rafts|stacks
lobby|foyer|antechamber|hall|anteroom|vestibul|entrance hall
located|set|situated|placed|settled
location|fix|locating|localization|localisation
locked|fast|barred|latched|bolted|secured|fastened
lodge|club|guild|orde|social club|society|gild
lone|alone|solitary|lonely|unaccompanied
lonely|alone|lone|solitary|unaccompanied
look|expression|face|facial expression|aspect
loose|escaped|free|on the loose|at large
lose|recede|fall behind|drop off|fall back
lost|perplexed|mixed-up|befuddled|mazed|bewildered|baffled|confounded|confused|at sea|bemused
lots|slews|wads|heaps|gobs|lashing|oodles|tons|dozens|mountain|scores|loads|scads|piles|rafts|stacks
loud|thunderous|audible|hearable|loud-mouthed|blaring|big|shattering|loud-voiced|shouted|harsh-voiced|clarion|earsplitting|thundery|roaring|deafening|blasting|trumpet-like|yelled|noisy|earthshaking|vocal
love|loved one|dearest|honey|dear|beloved
loved|favored|white-haired|idolised|best-loved|favourite|wanted|blue-eyed|idolized|admired|dear|treasured|fair-haired|favorite|precious|pet|beloved|cherished|adored|preferred|worshipped|darling|preferent
lovely|adorable|lovable|endearing|loveable
loving|caressing|adoring|loverly|overfond|gaga|amorous|affectionate|caring|charmed|dotty|attached|captivated|crazy|affectioned|idolatrous|committed|lovable|tenderhearted|romantic|warm|taken with|touchy-feely|infatuated|admiring|amative|amatory|fond|loverlike|warmhearted|enamored|doting|in love|smitten|caressive|uxorious|fatherly|loveable|lovesome|passionate|tender|soft on
luck|fortune|destiny|lot|fate|circumstances|portio
lucky|hot|serendipitous|fortunate|apotropaic
machine|automobile|car|motorcar|auto
madonna|Blessed Virgin|Madonn|Mary|The Virgin|Virgin Mary
magic|wizardly|magical|sorcerous|witching|wizard|charming|supernatural
magical|wizardly|sorcerous|witching|wizard|charming|supernatural|magic
magnet|attractor|attracter|attraction|attractive feature
maiden|first|initiative|opening|initiatory|inaugural
mail|ring armor|ring mail|chain mail|chain armor|ring armou|chain armour
mailman|letter carrier|mail carrier|postman|carrier
main|chief|principal|primary|important|of import
mainly|primarily|principally|in the main|chiefly
male|manlike|manly|masculine|virile|manful
mall|shopping mall|shopping center|center|shopping centre|plaza
manage|get by|grapple|cope|make out|contend|make do|deal
manner|mode|style|way|fashion
many|more|galore|many an|umpteen|some|umteen|numerous|many a|many another
marked|starred|well-marked|asterisked|scarred
married|joined|ringed|wed|mated|united|wedded
mass|aggregated|aggregative|collective|aggregate
matched|paired|one-to-one|twin|duplicate|mated|compatible|matching|well-matched|co-ordinated|twinned|coordinated
material|reincarnate|corporate|corporal|bodied|embodied|corporeal|incarnate|bodily
mating|union|conjugation|pairing|coupling|sexual unio
matt|mat|matte|matted|dull|flat
mature|old|headed|overblown|fully grown|fruiting|full-grown|prime|adult|marriageable|grown|abloom|matured|nubile|full-blown|meridian|efflorescent|big|grownup
maybe|possibly|perhaps|perchance|mayhap|peradventur
meaningful|meaty|meaning|purposeful|substantive|significant|pregnant|important
mechanical|mechanized|windup|robotlike|automatonlike|mechanistic|automatic|mechanised|machinelike|mechanic
medal|decoration|ribbo|medallion|palm|laurel wreath
memory|memory board|computer storage|computer memory|storage|store
mention|credit|reference|acknowledgment|citation|quotatio|cite
menu|carte du jour|bill of fare|carte|card
mercury|atomic number 8|hydrargyrum|Hg|quicksilver
merely|simply|only|but|just
merge|combine|fuse|coalesce|flux|immix|meld|blend|conflate|commingle|mix|mix up
merry|brisk|snappy|zippy|rattling|spanking|lively|energetic
mess|flock|muckle|lot|heap|spate|pile|mass|peck|stack|whole lot|great deal|pot|quite a little|mint|raft|hatful|whole sle|plenty|wad|good deal|tidy sum|mickle|batch|slew|sight|deal
metal|antimonial|gilded|metallic|gold-bearing|metal-looking|silver|bimetal|bimetallic|tinny|argentiferous|aluminiferous|all-metal|auriferous|bronze|metallike|golden|gold|metallic-looking
metallic|antimonial|gold|gilded|metal-looking|gold-bearing|silver|bimetal|bimetallic|tinny|argentiferous|aluminiferous|all-metal|auriferous|bronze|metallike|golden|metal|metallic-looking
metric|measured|metrical|rhythmic|rhythmical
metro|tube|subway|underground|subway system
middle|midway|halfway|center|central
mile|nautical mile|knot|air mil|mi|naut mi|international nautical mile
military|study|subject area|subject field|bailiwick|discipline|field|subject|branch of knowledge|field of study
mime|pantomimis|pantomimer|mimer|mummer
mind|nou|brain|psyche|head
minimal|nominal|stripped|borderline|tokenish|stripped-down|minimum|token|marginal|negligible
minimum|nominal|minimal|stripped|borderline|tokenish|stripped-down|token|marginal|negligible
minister|rector|curate|minister of religion|parson|pastor
minute|atomlike|microscopical|atomic|microscopic
miss|girl|missy|young lady|young woman|fille
missing|lacking|absent|wanting|nonexistent
mixed|blended|amalgamated|intermingled|integrated
mixing|mixture|admixture|commixture|intermixture|mix
mixture|miscellanea|variety|miscellany|potpourri|smorgasbord|salmagundi|mixed bag|assortment|motle
mobile|waterborne|rotatable|versatile|floating|seaborne|moveable|racy|motorized|maneuverable|motile|mechanised|manoeuvrable|transferrable|airborne|transplantable|ambulant|flying|moving|rangy|raisable|perambulating|ambulatory|movable|transferable|transportable|raiseable|mechanized
mode|manner|style|way|fashion
moderate|fairish|middle-of-the-road|minimalist|intermediate|modest|mild|conservative|cautious|average|limited|small|temperate|indifferent|fair|reasonable|medium
modern|forward-looking|innovative|progressive|advanced
modified|qualified|adapted|varied|restricted|altered
monkey|rascal|scallywag|scalawag|imp|scamp|rapscallion
monster|demon|devil|fiend|ogre
moral|honourable|clean|righteous|honorable|good|moralistic|incorrupt|chaste|virtuous|clean-living
morning|sunup|dawn|break of the day|dayspring|sunrise|first light|break of day|cockcro|aurora|dawning|daybreak
mortality|fatality rate|death rate|mortality rate|deathrate
most|all but|about|virtually|well-nig|nearly|just about|almost|nigh|near
motivated|impelled|driven|intended|actuated
moved|emotional|sick|stirred|affected|touched
movie|moving-picture show|picture show|flic|moving picture|motion-picture show|pic|film|motion picture|picture
moving|affecting|poignant|heartwarming|emotional|impressive|stimulating|stirring|touching|soul-stirring|haunting
much|more|untold|some|more than|overmuch|such|so much
multiple|triple|ternary|multiplex|four-fold|septuple|sextuple|bigeminal|sixfold|eight-fold|nine-fold|three-fold|tenfold|manifold|six-fold|double|fivefold|sevenfold|duplex|twofold|quintuple|triune|doubled|two-fold|quadruplicate|nonuple|aggregate|ninefold|quadruplex|fourfold|quadruple|duple|quaternary|denary|five-fold|threefold|ten-fold|seven-fold|octuple|treble|eightfold|binary|dual|triplex|quaternate
murphy|white potato|potato|spud|tater|Irish potato
muscle|brawn|sinew|heftines|muscularity|brawniness
mysterious|inscrutable|cryptical|deep|inexplicable|cryptic|incomprehensible|mystifying
naked|au naturel|bare|unclothed|nude
nasty|filthy|unpleasant|lousy|mean|awful|grotty|hateful|dirty
naughty|risque|blue|juicy|racy|gamey|gamy|sexy|spicy
nearly|all but|most|well-nigh|about|virtually|just about|almost|nigh|near
necessary|essential|requisite|obligatory|incumbent|indispensable|needful|needed|required
necessity|necessary|requisite|essential|requirement
needed|needful|required|necessary|requisite
negative|destructive|pessimistic|counter|perverse|unsupportive|antagonistic
nerve|brass|boldness|face|cheek
nest|draw close|nestle|nuzzle|snuggle|cuddle
newbie|neophyte|freshman|entran|starter|fledgeling|fledgling|newcomer
newly|recently|new|fresh|freshly
nickname|moniker|cognomen|sobriquet|soubriquet|bynam
noble|blue|aristocratic|blue-blooded|kingly|patrician|princely|monarchical|majestic|grand|regal|titled|queenly|gentle|royal|kinglike|monarchal|highborn|aristocratical|coroneted|purple|august|queenlike|lordly|imperial
noon|high noon|midday|noontide|noonday|twelve noon
normal|sane|typical|modal|average|standard|mean|natural|regular|median
normally|ordinarily|commonly|unremarkably|usually
north|northward|northeast|northeasterly|northwesterly|northerly|north-central|northernmost|northbound|northeastward|northwestward|northern|northmost|northwestern|northeastern|northwest
northern|Yankee|blue|Federal|Union
noted|illustrious|celebrated|renowned|known|famed|famous|notable|far-famed
nothing|nix|zipp|cipher|aught|null|zip|nil|naught|zilch|zero|nada|cypher|goose egg
notify|give notice|advise|apprise|send word|appriz
notion|impression|feeling|opinion|belief
novelty|trinke|gaud|fallal|bangle|gewgaw|bauble
number|bi|turn|routine|act
nutrition|alimentation|aliment|nutriment|sustenance|victual|nourishment
nuts|bats|loony|loco|dotty|around the bend|insane|cracked|fruity|balmy|nutty|bonkers|daft|round the bend|crackers|buggy|kookie|loopy|barmy|haywire|batty|kooky|whacky|wacky
obvious|self-explanatory|overt|patent|evident|plain|demonstrable|taken for granted|apparent|open-and-shut|axiomatic|self-evident|writ large|open|transparent|unmistakable|provable|manifest|frank
obviously|evidently|plain|manifestly|plainly|patently|apparently
occasion|function|social function|affair|social occasion
occupation|business|line of work|lin|job
occupied|filled|in use|engaged|busy
offensive|disgusting|repellent|obscene|repelling|skanky|horrific|sepulchral|ghoulish|verminous|distasteful|abhorrent|wicked|objectionable|repugnant|unpleasant|charnel|detestable|repellant|rank|loathsome|yucky|hideous|creepy|hateful|loathly|evil|obnoxious|revolting|unpalatable|ghastly|repulsive|horrid|morbid|foul|outrageous|scrimy|disgustful
offer|crack|pass|whir|go|fling
office|agency|government agency|bureau|federal agency|authority
offset|first|start|outset|get-go|commencement|showtim|starting time|beginning|kickoff
often|oft|frequently|ofttimes|oftentimes
okay|satisfactory|hunky-dory|fine|all right|o.k.|ok
older|elderly|aged|senior|old
once|formerly|erstwhile|erst|at one time
opened|agaze|staring|yawning|open|wide|agape|gaping|wide-eyed
opening|first|starting|initiative|maiden|introductory|beginning|initiatory|inaugural
opinion|impression|notion|feeling|belief
opposite|diametrical|diametric|different|polar
optical|ocular|visual|optic|exteroception|sensory system|sense modality|modality
optional|nonmandatory|facultative|ex gratia|nonobligatory|elective
oracle|seer|vaticinator|prophet|prophesier
order|club|guild|social club|society|gild|lodg
ordered|arranged|set|placed|laid
organic|constitutional|constitutive|essential|constituent
organised|organized|unionised|union|unionized
organized|re-formed|corporate|formed|reorganized|reorganised|arranged|designed|configured|incorporated|structured
oriented|homeward|familiarised|headed|orientated|homeward-bound|orientating|orienting|bound|directed|familiarized|adjusted|destined|minded
origin|root|beginning|rootage|source
original|innovational|avant-garde|germinal|creative|first|innovative|underivative|primary|unconventional|newfangled|new|novel|groundbreaking|freehand|daring|fresh|seminal|freehanded|originative
originally|earlier|in the first place|to begin with|in the beginning
other|another|else|otherwise|different|new|some other|separate|opposite
outcome|issue|result|event|effect|consequence|upshot
outdoor|out-of-door|alfresco|open-air|exterior|outdoorsy|outside
outside|external|after-school|extracurricular|right
oval|elliptic|oval-shaped|ovate|elliptical|ovoid|rounded|egg-shaped|oviform|prolate
over|ended|concluded|finished|terminated|all over|complete
overcome|get over|subdue|master|surmount
safe|dependable|good|sound|secure
sailing|soaring|glide|sailplaning|gliding
salary|remuneration|pay|wage|earnings
salon|beauty salon|beauty parlour|beauty shop|beauty parlor
samba|obeche|Triplochiton scleroxcylon|obechi|arere
same|aforesaid|aforementioned|said|selfsame|very|identical
sand|backbone|gumption|guts|moxie|grit
savage|uncivilized|wild|noncivilized|uncivilised|noncivilised|barbarian|barbaric
saved|regenerate|salvageable|blessed|blest|rescued|ransomed|found|redeemed|reclaimed
scary|chilling|shivery|shuddery|scarey|alarming
scores|slews|wads|heaps|gobs|lashing|oodles|tons|dozens|mountain|loads|scads|piles|lots|rafts|stacks
scout|lookout|picke|lookout man|sentinel|spotter|sentry|watch
screw|jailer|jailor|turnkey|prison guard|gaoler
scroll|gyre|coil|whorl|ringlet|curl|curlicue|roll
seat|fanny|posterior|bottom|bum|hindquarters|rear|nates|tooshie|backside|tail end|arse|buttocks|fundament|tail|derriere|as|stern|can|buns|behind|hind end|prat|butt|keister|tush|rear end|rump
secondary|auxiliary|tributary|supplemental|alternative|vicarious|inessential|thirdhand|collateral|secondhand|utility|indirect|unessential|supplementary|unoriginal|second-string|substitute|subsidiary|standby|alternate
secret|surreptitious|hush-hush|underground|clandestine|hole-and-corner|cloak-and-dagger|undercover|hugger-mugger|covert
secure|dependable|safe|good|sound
secured|fast|barred|locked|latched|bolted|fastened
selected|designated|elite|chosen|hand-picked|elect
self|someone|somebody|person|mortal|soul|individual
seller|vendor|vender|marketer|trafficker
senate|US Senate|United States Senate|Senat|U.S. Senate
send|air|transmi|broadcast|beam
senior|elderly|aged|old|older
sense|gumption|common sense|good sense|mother wit|horse sense
sensitive|responsive|alive|oversensitive|huffy|touchy|thin-skinned|feisty
separate|segregated|other|unshared|isolable|single|unaccompanied|individual|apart|unintegrated|detached|independent|discrete|asunder|abstracted|divided|separated|disjoint|disjunct|isolated|set-apart|distinct|removed
separately|individually|singly|on an individual basi|severally|one by one
sept|family|folk|family line|kinfolk|kinsfolk|phratr
sequence|chronological sequence|chronological succession|succession|successiveness
serial|consecutive|ordered|successive|sequential|sequent
serious|critical|grievous|severe|grave|dangerous|life-threatening
settled|effected|appointed|accomplished|decreed|set|firm|prescribed|established|determined|preconcerted|ordained|dictated|deterministic
severe|stern|stark|plain|austere
shade|wraith|spook|spectre|ghost|specter
shadow|phantasma|fantas|apparition|phantom|phantasm
shaft|beam of light|beam|light beam|shaft of light|irradiatio|ray of light|ray
shaved|smooth-shaven|beardless|clean-shaven|shaven|well-shaven|whiskerless
sheer|downright|right-down|out-and-out|absolute|rank|complete
shift|teddy|chemise|slip|shimmy
shine|radiancy|refulgence|radiance|refulgenc|effulgence
shipment|payload|load|consignmen|cargo|freight|lading|loading
shoot|flash back|scoot|dash|flash|scud|dart
short|abbreviated|fleeting|short and sweet|little|shortened|brief|short-run|clipped|short-range|momentaneous|short-term|momentary|fugitive|truncated|short-dated
shortly|briefly|concisely|in brief|in short
shorts|underdrawers|boxers|boxershorts|drawers
shot|changeable|colorful|chatoyant|iridescent|colourful
shut|compressed|winking|closed|tight|squinched|squinting|blinking
sick|insane|disturbed|mad|unbalanced|distracted|crazy|unhinged|brainsick|demented
sight|flock|muckle|lot|heap|spate|pile|mass|peck|mess|stack|whole lot|great deal|pot|quite a little|mint|raft|hatful|whole sle|plenty|wad|good deal|tidy sum|mickle|batch|slew|deal
sign|communicatory|gestural|signed|sign-language|communicative
silent|mute|inarticulate|dumb|unarticulate
silly|light-headed|featherbrained|giddy|dizzy|airheaded|lightheaded|empty-headed|frivolous
silver|achromatic|silverish|argent|silvery
similar|mistakable|siamese|analogous|corresponding|confusable|twin|quasi|correspondent|same|connatural|related|kindred|akin
sing|spill the beans|peach|babble|babble out|talk|tattle|let the cat out of the bag|blab ou|blab
singing|cantabile|musical|melodic|melodious
single|only|unary|uninominal|one-man|one-person|azygous|singular|unique|solitary|lonesome|sui generis|one-woman|azygos|lone|one-member|sole
situated|set|placed|settled|located
sized|medium-sized|crow-sized|human-sized|sorted|threepenny|size|cookie-sized|apple-sized|turkey-sized|squirrel-sized|grape-sized|ferret-sized|wolf-sized|moderate-sized|sparrow-sized|shrew-sized|dog-sized|kiwi-sized|orange-sized|ninepenny|mouse-sized|rabbit-sized|pig-sized|eightpenny|moderate-size|medium-size|cherry-sized|fourpenny
skill|accomplishment|acquirement|acquisition|attainment
skilled|hot|experienced|versatile|practiced|virtuoso|consummate|proficient|trained|accomplished|experient|skillful|expert|masterly|masterful|sure-handed|skilful|delicate|good|arch|adept|ball-hawking|mean|competent|complete
skirt|chick|bird|dame|wench|doll
slave|bond|unfree|servile|enthralled|slaveholding|in bondage|enslaved
slight|weak|thin|tenuous|flimsy
slim|svelte|thin|lean|slender|slight
slow|moderato|largo|andante|lentissimo|larghetto|larghissimo|lento|adagio
small|decreased|reduced|diminished|belittled
smart|astute|canny|street smart|sharp|cagy|with-it|shrewd|clever|cagey|intelligent|streetwise
smell|olfactory perception|olfactory sensation|odour|odor
smoke|hummer|bullet|heater|fastball
smooth|flowing|waxlike|uncreased|sleek|silky|fast|fine|even|silklike|silken|velvet-textured|smooth-textured|even-textured|satiny|slick|glossy|unseamed|velvet|seamless|wax-coated|unlined|ironed|velvety|aerodynamic|slippery|streamlined|fine-textured|creaseless|waxy|ceraceous|slippy|glassy
snow|blow|coke|C|nose candy
soap|scoop|easy lay|goop|liquid ecstasy|Georgia home boy|grievous bodily harm|max
social|ethnic|friendly|sociable|ethnical|multiethnic|cultural|multi-ethnic|gregarious|interpersonal
society|club|guild|lodge|orde|social club|gild
software|computer software|software system|package|software package|software program
soil|grunge|dirt|filth|grime|grease|stain
solely|exclusively|alone|only|entirely
solid|congealed|concrete|jellied|dry|hard|solidified|jelled|coagulated|solid-state|semisolid
solution|result|solvent|answer|resolution
some|whatsoever|many|whatever|several|both|few|any
somebody|someone|person|mortal|soul|individual
someone|somebody|person|mortal|soul|individual
somerset|somersault|flip|somersaulting|summerset|summersault
somewhat|within reason|fairly|moderately|reasonably|middling|passably
sorry|disconsolate|drab|depressing|blue|dispiriting|dreary|dark|gloomy|cheerless|dismal|dingy|grim|drear|uncheerful
soul|someone|somebody|person|morta|individual
source|root|beginning|rootage|origin
south|south-central|southwestern|southerly|southernmost|southeast|southward|southeastern|southeasterly|southeastward|southmost|southwestward|southern|southwest|southbound|southwesterly
spanking|brisk|merry|snappy|zippy|rattling|lively|energetic
spare|meagerly|scrimpy|stingy|meagre|meager|bare|scanty
speaker|loudspeaker|loudspeaker system|speaker unit|speaker system
special|particular|exceptional|especial|uncommon
specialty|strong point|speciality|long suit|forte|strength|metier|strong suit
specific|ad hoc|special|peculiar|particularised|precise|particularized|limited|circumstantial|unique|specialised|particular|specialized|proper
specified|nominal|mere|specific|nominative
spent|worn out|washed-out|exhausted|fatigued|tired|fagged|worn-out|dog-tired|played out
sphere|firmament|welki|vault of heaven|heavens|celestial sphere|empyrean
spirits|hard drink|hard liquor|John Barleycorn|liquor|booze|strong drink
spiritual|phantasmal|spectral|ghostly|ghostlike|apparitional|supernatural
spoken|oral|unwritten|uttered|expressed|word-of-mouth|verbalised|verbalized|articulate|viva-voce|verbal
spouse|married person|better half|partner|mate
spray|atomizer|atomiser|nebulise|nebulizer|sprayer
spreading|diffusing|disseminative|scattering|disseminating|diffusive|distributive|dispersive
spring|natural spring|outflow|fountain|outpouring
square|hearty|wholesome|solid|satisfying|substantial
stack|flock|muckle|lot|heap|spate|pile|mass|peck|mess|whole lot|great deal|pot|quite a little|mint|raft|hatful|whole sle|plenty|wad|good deal|tidy sum|mickle|batch|slew|sight|deal
stainless|unstained|untarnished|untainted|unblemished|unsullied
standard|classic|criterial|canonical|casebook|classical|accepted|criterional|definitive|textbook|canonic|basic|orthodox|authoritative
standing|still|stagnant|dead|slack
star|prima|starring|leading|major|stellar
starring|star|prima|leading|major|stellar
start|first|outset|showtime|get-go|commencement|starting time|beginning|kickoff|offse
stay|check|stop|hitch|halt|arrest|stoppage
steady|steadied|steady-going|stable|even|firm|level|unagitated|footsure|dependable|rock-steady|sure|sure-footed|unwavering|surefooted|regular
stereo|two-channel|stereophonic|binaural|biaural
still|nonmoving|static|motionless|inactive|unmoving
stock|well-worn|threadbare|timeworn|trite|unoriginal|shopworn|old-hat|banal|commonplace|hackneyed|tired
stop|check|hitch|halt|stay|stoppag|arrest
stops|Michigan|Newmarket|boodle|Chicago
storage|memory board|computer storage|computer memory|memory|store
store|memory boar|computer storage|computer memory|memory|storage
story|tale|fib|tarradiddle|taradiddle
strange|exotic|imported|unnaturalized|foreign|adventive|nonnative|established|naturalized|unnaturalised|tramontane|foreign-born|alien
strike|hit|smasher|smash|bang
strong|noticeable|beardown|beefed-up|virile|powerful|stiff|strengthened|tough|weapons-grade|well-set|fortified|vehement|ironlike|bullnecked|reinforced|bullocky|knockout|well-knit|robust|brawny|hard|knock-down|severe|muscular|industrial-strength|hefty|sinewy|rugged|toughened
structure|anatomical structure|bodily structure|body structure|complex body part
stupid|dazed|stupefied|confused|stunned
style|flair|elan|dash|panach
stylish|smart|fashionable|swish|chichi|posh|classy|chic|voguish|snazzy
submit|give in|defer|accede|bow
subsequent|later|consequent|ensuant|ulterior|succeeding|future|resulting|sequent|resultant
subsidiary|auxiliary|adjunct|supportive|accessory|ancillary|adjuvant|appurtenant
substance|meat|sum|heart and soul|nitty-gritt|center|inwardness|gist|core|pith|nub|heart|essence|marrow|kernel
successful|flourishing|productive|self-made|triple-crown|fortunate|undefeated|booming|prospering|roaring|in|made|victorious|palmy|eminent|thriving|prosperous|winning|sure-fire|boffo|no-hit
sudden|fast|fulminant|abrupt|sharp|unforeseen|jerky|emergent|choppy|unexpected|explosive
suffer|endure|put u|support|stand|stick out|brook|tolerate|stomach|digest|abide|bear
sufficient|ample|decent|enough|adequate|comfortable
sugar|simoleons|lolly|cabbage|gelt|lettuce|scratch|moolah|kale|bread|boodle|pelf|shekels|wampu|dinero|dough|loot|clams|lucre
summary|succinct|concise|compendious|compact
summit|acme|elevation|height|superlative|peak|meridian|tiptop|to|pinnacle
sunny|shiny|bright|clear|shining|sunshiny
super|crack|topnotch|fantastic|A-one|superior|first-rate|tiptop|tops|ace
superior|first-class|superb|sterling|topping|brilliant|spiffing|well-made|gilt-edged|choice|brag|banner|ace|super|blue-ribbon|pucka|weapons-grade|best|pukka|top-flight|A-one|outstanding|select|prime|boss|topnotch|high-performance|quality|greatest|excellent|surpassing|crack|capital|superlative|premium|fantastic|top-hole|first-rate|transcendent|tiptop|prize|supreme|fantabulous|shining|tops
supported|fostered|backed|backed up|subsidized|based on|subsidised|verified|founded|endorsed|based|nourished|financed|corroborated|substantiated
sure|confident|positive|convinced|certain
surely|sure enough|for sure|certainly|sure as shootin|sure|for certain
surface|opencast|aboveground|opencut|grade-constructed
surgery|OR|operating theatr|operating theater|operating room
surplus|supererogatory|unnecessary|supernumerary|spare|superfluous|extra|redundant|excess|unneeded
surprised|astonied|goggle-eyed|dumfounded|flabbergasted|jiggered|stunned|astonished|thunderstruck|dumbstricken|astounded|openmouthed|gobsmacked|popeyed|startled|dumbstruck|dumbfounded|stupefied|amazed
surprising|startling|amazing|stunning|unexpected|astonishing
suspect|shady|fishy|questionable|suspicious|funny
sweet|angelical|cherubic|loveable|angelic|lovable|seraphic
systematic|systematized|systematised|in order|organized|regular|tabular
tackle|fishing rig|fishing tackle|rig|fishing gear
tail|fanny|posterior|bottom|bum|hindquarters|rear|nates|tooshie|backside|tail end|arse|buttocks|fundament|derriere|as|stern|can|buns|behind|hind end|prat|butt|keister|seat|tush|rear end|rump
take|issue|return|proceeds|payoff|yield|takings
tale|fib|story|tarradiddle|taradiddle
teaching|pedagogy|education|educational activity|didactics|instruction
teddy|chemise|shift|slip|shimmy
teen|teenage|young|immature|teenaged|adolescent
teenage|young|immature|teenaged|adolescent|teen
temporary|ephemeral|unstable|acting|terminable|impermanent|passing|fly-by-night|jury-rigged|transient|working|pro tem|short-lived|transitory|fugacious|improvised|makeshift|pro tempore|temporal|episodic|evanescent|interim
tend|lean|incline|be given|run
tender|fond|lovesome|affectionate|caring|loving|warm
terminal|final|last|closing|concluding
terrible|dreadful|abominable|bad|painful|awful|atrocious|unspeakable
tested|time-tested|tried and true|dependable|tried|reliable
text|text edition|school tex|schoolbook|textbook
theater|dramatics|theatre|dramatic art|dramaturgy
theatre|dramatics|dramatic art|theater|dramaturgy
theft|thievery|larceny|thieving|stealing
thin|weak|slight|tenuous|flimsy
thou|1000|chiliad|grand|yard|K|G|thousand|M|one thousand
thousand|1000|m|cardinal|one thousand|k
thunder|nose drops|sca|hell dust|skag|big H|smack
tight|pixilated|squiffy|inebriated|blind drunk|sloshed|cockeyed|fuddled|smashed|sozzled|plastered|stiff|pie-eyed|crocked|slopped|wet|soused|intoxicated|pissed|besotted|tipsy|soaked|tiddley|loaded|blotto|drunk|tiddly|potty
tiny|diminutive|lilliputian|flyspeck|petite|little|midget|small|bantam
tired|worn out|all in|bored|travel-worn|flagging|exhausted|blear|dog-tired|ragged|dead|aweary|drooping|blear-eyed|burned-out|washed-out|beat|whacked|unrested|jaded|careworn|knackered|raddled|fatigued|unrefreshed|bleary|world-weary|spent|burnt-out|worn-out|drained|played out|worn|wearied|bushed|bleary-eyed|fagged|haggard|drawn|weary|footsore
titled|called|styled|entitled|known as|named
toilet|can|crapper|pot|stool|throne|commode|potty
token|minimum|nominal|tokenish|minimal
tons|slews|wads|heaps|gobs|lashing|oodles|dozens|mountain|scores|loads|scads|piles|lots|rafts|stacks
tops|super|crack|topnotch|fantastic|A-one|superior|first-rate|tiptop|ace
totally|altogether|all|wholly|entirely|whole|completely
touring|road|moving|itinerant|traveling
toxic|venomous|nephrotoxic|noxious|toxicant|cyanogenic|harmful|ototoxic|deadly|poisonous|unhealthful|virulent|hepatotoxic|cyanogenetic
tragedy|catastrophe|calamity|cataclys|disaster
trailer|lagger|drone|pok|dawdler|laggard
trained|pot-trained|drilled|toilet-trained|potty-trained|housebroken|house-trained|disciplined
transmit|air|broadcast|send|beam
trash|codswallo|applesauce|trumpery|wish-wash|folderol|rubbish|tripe
traveling|road|moving|touring|itinerant
treat|kickshaw|goody|dainty|delicacy
treated|fumed|burnt|burned|processed|aerated|doped|activated|proofed
trick|prank|joke|antic|put-on|caper
tried|proven|tested|proved|well-tried
trinity|trey|ternary|leash|threesome|ternion|trine|tercet|terzetto|triad|triplet|deuce-ac|3|trio|three|troika|III|tierce
trio|trey|ternary|trinity|leash|threesome|ternion|trine|tercet|terzetto|triad|triplet|deuce-ac|3|three|troika|III|tierce
triple|ternary|multiple|treble|triplex
tube|subway|metro|underground|subway system
tune|strain|melody|air|melodic phras|melodic line|line
turn|bi|number|routine|act
turned|upset|upturned|revolved|overturned|upside-down|wrong-side-out|inside-out|rotated|inverted|reversed
twelve|cardinal|dozen|12|xii
twin|twinned|matching|duplicate|matched
face|brass|boldness|nerve|chee
faced|pug-faced|two-faced|visaged|Janus-faced|baby-faced|sweet-faced|round-faced|long-faced|sad-faced|bald-faced|pale-faced|moon-faced|featured
facility|quickness|adeptness|deftness|adroitness
fair|mediocre|average|ordinary|middling
fairy|fay|faery|sprite|faerie
fake|bogus|imitative|phony|counterfeit|phoney
familiar|acquainted|familiar with|old|well-known|known|beaten|acquainted with|long-familiar
famous|illustrious|celebrated|noted|renowned|known|famed|notable|far-famed
fancy|puff|fanciful|lacy|lacelike|vermiculated|rhetorical|crackle|elaborate|churrigueresque|garnished|adorned|flamboyant|dressy|vermicular|busy|fussy|castellated|crenelated|rococo|damask|puffed|churrigueresco|crenelate|crenellated|crenellate|decorated|castled|indented|vermiculate|damascene|battlemented|fantastic|florid|baroque|embattled|aureate|luxuriant
fantastic|super|crack|topnotch|A-one|superior|first-rate|tiptop|tops|ace
fashion|manner|style|way|mode
fast|hot|rapid|hurried|prompt|winged|high-velocity|hurrying|instantaneous|blistering|fast-breaking|meteoric|quick|red-hot|straightaway|alacritous|expedited|immediate|speedy|sudden|accelerating|smart|swift|express|windy|scurrying|speeding|instant|high-speed|fleet|fast-paced|double-quick|accelerated
fatal|calamitous|disastrous|black|unfortunate|fateful
fatty|oily|greasy|oleaginous|buttery|adipose|superfatted|fat|sebaceous|suety
favorite|preferred|favourite|favored|preferent|pet|loved|best-loved
favourite|preferred|favorite|favored|preferent|pet|loved|best-loved
feel|smel|feeling|flavour|spirit|tone|flavor|look
feeling|impression|notion|opinion|belief
fell|barbarous|roughshod|brutal|vicious|inhumane|cruel|savage
fellow|boyfriend|beau|young man|swain
felt|matte|mat up|felt up|ma|matte up|matt-up
fever|pyrexia|febricity|feverishness|febrility
filter|separate out|strain|filtrate|filter out
final|closing|last|concluding|terminal
finances|funds|pecuniary resourc|cash in hand|monetary resource
financial|commercial enterprise|business|business enterprise|fiscal
fine|satisfactory|hunky-dory|all right|o.k.|okay|ok
finished|ended|concluded|done with|fin de siecle|done|terminated|through with|over|through|all over|up|complete
finite|exhaustible|mortal|limited|impermanent|bounded|delimited
fire|fervency|fervour|fervor|ardour|fervidness|ardor
fired|pink-slipped|discharged|unemployed|dismissed|laid-off
fiscal|commercial enterprise|business|financial|business enterprise
flash|meretricious|tawdry|tasteless|gimcrack|brassy|gaudy|tatty|garish|tacky|flashy|loud|cheap|trashy
flat|savourless|tasteless|vapid|savorless|bland|insipid|flavorless|flavourless
flesh|physique|figure|anatomy|human body|shape|soma|material body|bod|build|for|chassis|frame|physical body
flip|impudent|snotty-nosed|disrespectful|insolent
fluid|liquid|fluent|graceful|smooth
flush|rich|affluent|wealthy|moneyed|loaded
flyer|airman|aviator|flier|aeronaut
flying|moving|flaring|waving|aflare
folder|pamphlet|booklet|brochure|leaflet
folding|foldable|foldaway|collapsable|collapsible
folk|family|family line|kinfolk|kinsfolk|phratr|sept
fool|sucker|soft touch|chump|mu|gull|patsy|mark|fall guy
forbidden|prohibited|proscribed|impermissible|taboo|tabu|verboten|out
forced|constrained|unnatural|affected|strained
foreign|international|abroad|overseas|outside|external
formation|constitution|establishment|organisation|organization
formerly|erstwhile|erst|once|at one time
fortune|destiny|lot|fate|circumstances|luck|portion
forty|cardinal|40|xl|twoscore
foundation|foot|base|groundwork|fundament|substructure|understructure
frank|plainspoken|direct|outspoken|straight-from-the-shoulder|forthright|point-blank|blunt|candid|free-spoken
fraud|humbug|hoax|fraudulence|put-on|dupery
free|gratuitous|gratis|complimentary|costless|unpaid
freight|payload|load|consignmen|shipment|cargo|lading|loading
frequently|oft|often|ofttimes|oftentimes
fresh|brisk|energising|refreshing|refreshful|energizing|invigorating|tonic|bracing
friendly|favorable|amicable|matey|sociable|social|companionate|cordial|cozy|informal|couthie|chummy|couthy|amiable|intimate|warm|congenial|palsy-walsy|affable|neighborly|well-disposed|hospitable|neighbourly|hail-fellow-well-met|hail-fellow|genial|gracious|pally|comradely
front|first|in advance|frontmost|foremost|advanced|advance|fore|frontal|head-on|anterior
full|awash|inundated|gas-filled|chockful|air-filled|overflowing|untasted|cram full|brimful|instinct|flooded|glutted|afloat|brimfull|congested|filled|chock-full|ladened|choke-full|chockablock|overfull|chuck-full|weighed down|riddled|sperm-filled|stuffed|overladen|untouched|brimming|laden|egg-filled|fraught|pregnant|heavy|well-lined|loaded|overloaded|replete|engorged
function|social function|occasion|affair|social occasion
funds|pecuniary resource|cash in hand|finances|monetary resource
funny|mirthful|risible|humorous|amusing|comical|comic|laughable|humourous
furnished|outfitted|appointed|equipped|furnished with|well-appointed|provided with|well-found|stocked|supplied with|stocked with|volumed|fitted out
future|proximo|rising|prospective|upcoming|prox|coming|early|approaching|incoming|emerging|future day|in store|forthcoming
fuzzy|muzzy|indistinct|bleary|blurry|hazy|foggy|blurred
game|crippled|lame|halt|gimpy|halting|unfit
geek|eccentric|eccentric person|oddbal|flake
general|universal|pandemic|unspecific|imprecise|unspecialized|all-purpose|broad|unspecialised|indiscriminate|general-purpose|miscellaneous|gross|generic|widespread|comprehensive|overall
generate|bring fort|beget|father|engender|sire|mother|get
genius|superstar|hotshot|whiz|sensation|champion|whizz|wi|wizard|maven|virtuoso|adept|star|mavin|ace
gentle|aristocratical|blue|noble|aristocratic|blue-blooded|patrician
gentleman|gentleman's gentleman|valet de chambre|valet|man
genuine|true|real|literal|actual
giant|gargantuan|large|jumbo|elephantine|big
given|tending|inclined|minded|disposed|apt
giving|liberal|bountiful|bighearted|bounteous|handsome|generous|freehanded|openhanded|big
global|spherical|spheric|circular|globose|ball-shaped|globular|round|orbicular
glory|nimbus|gloriole|halo|aureole|aura
gold|gilded|chromatic|gilt|aureate|golden
golden|gilded|chromatic|gilt|aureate|gold
gone|at peace|at rest|asleep|departed|deceased|dead
good|skilled|skilful|practiced|skillful|expert|adept|proficient
gossip|chin-wag|small talk|causerie|tittle-tattle|gab|chin-wagging|gabfest|chitchat
gourmet|foodie|bon vivant|gastronome|epicure|epicurean
governance|administration|establishment|organization|brass|governing body|organisatio
grad|alum|graduate|alumnus|alumna
graduation|commencement ceremony|graduation exercise|commencement|commencement exercise
granny|gran|grandma|grandmother|grannie
grass|pasture|eatage|pasturage|forage
gratis|gratuitous|free|complimentary|costless|unpaid
grave|critical|grievous|severe|dangerous|serious|life-threatening
gravity|graveness|sombreness|soberness|somberness|sobriety
gray|cloudy|grey|dull|leaden
great|avid|zealous|eager|enthusiastic
green|naive|gullible|fleeceable|naif
grey|cloudy|gray|dull|leaden
gross|stark|unadulterated|perfect|staring|utter|arrant|unmitigated|everlasting|thoroughgoing|sodding|double-dyed|consummate|complete|pure
grow|acquire|produce|get|develop
grown|mature|fully grown|full-grown|adult|big|grownup
guaranteed|secure|warranted|secured|bonded
guardian|protective|tutelary|custodial|tutelar
guess|conjecture|surmise|supposition|speculation|hypothesi|surmisal
guidance|counseling|direction|counsel|counselling
guild|club|lodge|social club|society|order|gild
guilty|red-handed|conscience-smitten|indictable|guilt-ridden|chargeable|blameworthy|culpable|condemned|censurable|inculpatory|convicted|delinquent|unrighteous|punishable|blamable|at fault|fineable|blameful|blameable|criminal|bloodguilty|inculpative|finable
hall|foyer|antechamber|lobby|anteroom|vestibul|entrance hall
halo|glory|nimbus|gloriol|aureole|aura
handmade|handsewn|handwoven|oversewn|overhand|handstitched|hand-loomed|camp-made|hand-crafted
hanging|pendent|dependent|supported|hanging down|pendant
happy|riant|cheerful|content|felicitous|joyous|glad|blessed|joyful|contented|laughing|prosperous|halcyon|elated|blissful|euphoric|golden|bright
hard|corneous|lignified|hornlike|hardened|unyielding|stonelike|petrified|semihard|steely|granitic|solid|al dente|ossified|rocklike|firm|stony|set|petrous|horny|tumid|adamantine|granitelike|woody|erect
hardcover|hardbound|hardbacked|hardback|backed
hardly|just|scarcely|scarce|barely
harmful|inauspicious|untoward|adverse|unfavourable|unfavorable
harry|chevvy|harass|hassle|chevy|chivvy|molest|chivy|provok|plague|beset
hazard|risk|endangerment|jeopardy|peril
hazardous|risky|dangerous|unsafe|wild
headed|bicephalous|headlike|burr-headed|large-headed
healing|alterative|therapeutic|curative|remedial|healthful|sanative
healthy|levelheaded|sensible|level-headed|sound|intelligent|reasonable
hear|find out|get a line|discover|pick up|learn|get wind|get word|see
heart|fondness|philia|affection|affectionateness|warmness|warmheartedness|tenderness
heated|hot|het up|heated up|het
heater|hummer|smoke|bulle|fastball
heaven|Eden|Nirvana|Shangri-la|paradise|promised land
heavy|punishing|gruelling|toilsome|grueling|hard|arduous|effortful|operose|backbreaking|laborious
heel|blackguard|houn|dog|bounder|cad
height|acme|elevation|summit|superlative|peak|meridian|tiptop|to|pinnacle
hello|hullo|how-do-you-do|hi|howdy
helpful|ministrant|implemental|attending|steadying|laborsaving|stabilising|useful|right-hand|accommodative|encouraging|face-saving|reformatory|reformative|assistive|laboursaving|facilitative|stabilizing|subservient|facilitatory|instrumental|adjuvant|ministering|utile|accommodating|cooperative
herbal|flavouring|seasoning|flavourer|seasoner|flavorer|flavoring
hero|ze|hero sandwich|hoagy|Italian sandwich|hoagie|Cuban sandwich|bomber|submarine sandwich|submarine|torpedo|poor boy|grinder|wedge|sub
hidden|unseeable|out of sight|concealed|invisible
high|overflowing|soaring|utmost|broad|advanced|superior|flooding|full|in flood|graduate|swollen|postgraduate|last|higher
highland|alpine|upland|alpestrine|subalpine|mountainous
hobby|spare-time activity|pursuit|avocation|sideline|by-line
hole|muddle|pickle|kettle of fish|mess|jam|fix
hollow|cavernous|tubelike|empty|fistulous|cannular|sunken|recessed|deep-set|tubular|fistular|fistulate|vasiform|tube-shaped
holy|sanctified|Blessed|sacred|consecrate|blessed|hallowed|consecrated|dedicated|beatified
home|interior|domestic|national|internal
homeland|motherland|native lan|country of origin|mother country|fatherland
honest|trusty|trustworthy|reliable|dependable|TRUE
honor|award|accolade|honour|laurel
hook|bait|come-on|sweetener|lure
horizon|apparent horizon|visible horizon|skyline|sensible horizon
horizontal|crosswise|naiant|level|swimming|flat
horn|automobile horn|motor horn|car horn|hooter
horrible|frightful|alarming|ugly|horrifying|atrocious
hostel|hostelry|lodge|auberg|inn
house|home|household|menage|family
household|menag|house|home|family
however|still|nonetheless|even so|all the same|withal|yet|nevertheless|notwithstandin
huge|Brobdingnagian|immense|vast|large|big
human|manlike|imperfect|frail|anthropoid|earthborn|hominal|hominine|weak|hominian|anthropomorphous|anthropomorphic|hominid|fallible|humanlike
humans|humanity|human race|human beings|man|world|mankind|humankind
hundred|c|cardinal|one hundred|100
hungry|wishful|athirst|desirous|thirsty
hybrid|crossbred|intercrossed|crossed|interbred
hypothesis|conjecture|surmise|supposition|speculation|guess|surmisal
identify|distinguish|discover|nam|key out|describe|key
idle|baseless|wild|groundless|unsupported|unwarranted|unfounded
ignore|brush off|disregard|dismiss|brush aside|push asid|discount
illegal|hot|outlawed|extralegal|irregular|misbranded|bootleg|black-market|outlaw|felonious|under-the-counter|smuggled|nonlegal|ill-gotten|unratified|contraband|unlawful|misappropriated|penal|dirty|amerciable|extrajudicial|punishable|illegitimate|black|ineligible|mislabeled|banned|prohibited|embezzled|illicit|criminal
imperial|noble|royal|regal|purple|majestic
implied|inexplicit|silent|implicit|tacit|understood
impossible|undoable|hopeless|unattainable|unrealizable|impractical|insurmountable|unfeasible|unachievable|unsurmountable|infeasible|unrealistic|unthinkable|impracticable|out|unworkable
impressive|thundering|dazzling|brilliant|amazing|stunning|noble|grandiose|gallant|sensational|astounding|awful|eye-popping|formidable|staggering|striking|fulgurant|awe-inspiring|proud|majestic|astonishing|arresting|grand|fulgurous|magnificent|signal|awesome|expansive|lofty|stately|dramatic|spectacular|stupefying|moving|glorious|palatial|heroic|awing|mind-boggling|imposing|splendid|baronial|important-looking
improve|meliorate|amend|better|ameliorate
incident|peripheral|omissible|incidental|parenthetic|secondary|parenthetical
incoming|inward|inbound|next|in|inpouring|succeeding|future|designate|elect|influent|inflowing
incomplete|half|fractional|sketchy|broken|rudimentary|uncomplete|unelaborated|partial|uncompleted
incorrect|wrong|improper|inaccurate|erroneous|false|fallacious|mistaken
increased|magnified|redoubled|accrued|enhanced|multiplied|augmented|accumulated|inflated|raised|hyperbolic|exaggerated|enlarged
incredible|undreamt of|undreamed of|implausible|tall|marvelous|incredulous|unconvincing|undreamt|unthinkable|astounding|fabulous|dumbfounding|undreamed|unimagined|marvellous|improbable|unbelievable|dumfounding
indigenous|autochthonic|native|autochthonal|endemic|autochthonous
indirect|circumlocutory|excursive|roundabout|backhanded|hearsay|circuitous|mealymouthed|mealy-mouthed|devious|digressive|oblique|tortuous|circumlocutious|periphrastic|rambling|discursive|ambagious|allusive
infected|contaminated|infectious|germy|contaminative|pussy|septicemic|putrefactive|pestiferous|unhealthful|septic|infective|abscessed|purulent|putrefacient|dirty
infectious|contractable|transmissible|corrupting|catching|contagious|contaminating|transmittable|communicable
inflation|ostentation|pompousness|pretentiousness|splashines|ostentatiousness|pomposity|puffiness
informed|enlightened|familiar|educated|sophisticated|abreast|wise|knowledgeable|hip to|well-read|advised|wise to|au fait|hep|hip|knowing|up on|privy|au courant|conversant
inherited|transmitted|hereditary|genetic|transmissible|inheritable|familial|heritable
initiative|first|maiden|opening|initiatory|inaugural
injured|cut|gashed|wounded|broken|battle-scarred|bruised|burned|maimed|impaired|torn|stabbed|mangled|harmed|mutilated|disabled|eviscerate|livid|hurt|disjointed|lacerate|unsound|dislocated|blistered|out of action|separated|black-and-blue|raw|slashed|hors de combat|damaged|contusioned|contused|lacerated
inner|inmost|inside|innermost|central
innocent|destitute|barren|devoid|empty
innovation|founding|initiation|origination|institution|introduction|creation|foundation|instauratio
innovative|forward-looking|progressive|modern|advanced
instant|insistent|crying|clamant|imperative|exigent
instantly|in real time|at once|straightaway|directly|immediately|right away|now|forthwith|straight off|like a sho
integral|constitutional|inbuilt|inherent|intrinsical|built-in|intrinsic
integrated|blended|mixed|amalgamated|intermingled
intent|wrapped|engrossed|absorbed|enwrapped|attentive|captive
intention|intent|aim|purpose|design
inter|bury|entomb|lay to rest|inhume
interior|domestic|home|national|internal
internal|interior|domestic|home|national
invalid|null|sophistical|invalidated|illegitimate|false|sophistic|bad|void|fallacious|unsound|uncollectible|nullified
invention|conception|excogitation|innovation|design
involved|up to our necks|up to her neck|up to your neck|up to their necks|up to my neck|entangled|implicated|caught up|participating|engaged|concerned|up to his neck|active|interested|embroiled|neck-deep
issue|upsho|outcome|result|effect|event|consequence
italic|face|fount|typeface|font
jail|slammer|jailhouse|clink|poky|pokey|gaol
john|can|lavatory|lav|bathroom|privy|toilet
join|joint|articulation|junction|juncture
joint|conjunct|corporate|shared|integrated|combined|conjoined|common|associated|united|conjoint|sharing|conjunctive|clannish|concerted|collective|cosignatory|cooperative
joke|prank|trick|put-o|antic|caper
josh|jolly|kid|chaff|banter
junior|lowly|lower-ranking|younger|subaltern|junior-grade|secondary|young|immature|subordinate|inferior|petty|minor|jr.
junk|dust|rubble|detritus|debris
juvenile|jejune|adolescent|immature|puerile
ugly|frightful|alarming|horrible|horrifying|atrocious
ultimate|last-ditch|net|eventual|final|crowning|supreme|last
ultimately|at last|in the end|at long las|finally
undefined|indefinable|indefinite|vague|undefinable
understood|taken|interpreted|comprehended|appreciated|apprehended
unified|interconnected|co-ordinated|coordinated|integrated
union|unionized|closed|organised|organized|unionised
unique|incomparable|unequaled|alone|unequalled|unparalleled|uncomparable
united|amalgamate|federate|integrated|confederate|unpartitioned|in agreement|conjugated|undivided|fused|coupled|unified|unsegmented|collective|merged|coalescent|suprasegmental|incorporated|incorporate|coalescing|allied|agreed|confederative|tied|unitary|conjugate|nonsegmental|amalgamated|in league|cohesive|conjunct|one|consolidated|joint|coalesced|federated
universe|cosmos|existence|macrocos|creation|world
unknown|unbeknownst|chartless|unbeknown|unidentified|inglorious|unheard-of|unexplored|transcendent|unacknowledged|undiagnosed|uncharted|unfamiliar|little-known|undiscovered|dishonorable|unmapped
unlikely|farfetched|remote|outside|implausible|last
unusual|different|peculiar|extraordinary|out-of-the-way|unique|odd|uncommon|unaccustomed
unwrap|give away|impart|discover|disclose|bring out|divulge|break|expose|let on|reveal|let ou
upcoming|future|approaching|forthcoming|coming
upgrade|acclivity|rise|raise|ascent|climb
upset|disordered|broken|confused|disorganised|disorganized
urban|city-born|city-bred|city-like|urbanised|cityfied|urbanized|citified
used|victimised|ill-used|misused|exploited|put-upon|victimized
useful|effectual|utilizable|profitable|recyclable|reclaimable|helpful|usable|effective|serviceable|efficacious|reusable|utilitarian|useable|multipurpose|utile|expedient
usual|customary|wonted|habitual|common|accustomed|regular
usually|ordinarily|normally|unremarkably|commonly
utilize|use|apply|employ|utilise
valid|effectual|validated|binding|sensible|reasoned|sound|logical|legitimate|reasonable|well-grounded|legal
valuable|invaluable|rich|worth|precious|important|expensive|of import|priceless|valued|semiprecious|blue-chip|worthy
vanilla|flavouring|seasoning|flavourer|seasoner|flavorer|flavoring
variety|miscellanea|mixture|miscellany|potpourri|smorgasbord|salmagundi|mixed bag|assortment|motle
vast|Brobdingnagian|immense|large|huge|big
vegetable|blackberry-like|seed-like|onion-like|melon-like|bean-like|parsley-like|vegetative|stemlike|gooseberry-like|stem-like|rooted|banana-like|moss-like|branch-like|gourd-like|stalk-like|mushroom-shaped|seedlike|cherry-like|stalklike|vegetal|crabapple-like|plant-like|rootlike|root-like|seed-producing|tomato-like|garlic-like|branchlike|cabbage-like|mosslike|vegetational|plum-shaped
vendor|seller|vender|marketer|trafficker
verify|aver|swear|avow|assert|affirm|swan
veterinary|physician|doc|MD|medical specialty|medicine|medico|doctor|Dr.
victorian|straitlaced|strait-laced|tight-laced|straight-laced|prissy|square-toed|straightlaced|prudish|prim|puritanical|proper|priggish
view|prospect|panoram|vista|scene|aspect
viewer|spectator|watcher|looke|witness
violence|vehemence|furiousness|fierceness|ferocity|wildness|fury
violent|hot|unpeaceful|terrorist|convulsive|furious|knockdown-dragout|lashing|raging|rampageous|ruffianly|knock-down-and-drag-out|hostile|slam-bang|lurid|tough|fierce|ferocious|savage
viral|infective agent|microorganism|micro-organism|infectious agent
virtually|all but|most|well-nigh|about|just about|nearly|almost|nigh|near
vista|prospect|panorama|scene|view|aspect
visual|ocular|optic|optical|exteroception|sensory system|sense modality|modality
vocational|job|business|occupation|line|line of work
voltage|potential difference|potential|potential dro|electric potential
voluntary|unpaid|self-imposed|volunteer|by choice|intentional|uncoerced|freewill|wilful|willing|conscious|willful|unforced
vulnerable|unguarded|endangered|indefensible|unsafe|under attack|undefended|dangerous|defenceless|susceptible|unprotected|open|conquerable|undefendable|compromising|penetrable|assailable|under fire|insecure|defenseless|threatened
wage|remuneration|pay|earnings|salary
wagon|beach wagon|station wagon|beach waggon|waggon|station waggon
wait|hold|delay|postponemen|time lag
wanted|cherished|loved|precious|treasured
warm|fond|lovesome|affectionate|caring|tender|loving
warning|exemplary|dissuasive|admonitory|cautionary|monitory
waste|inhospitable|desert|godforsaken|wild
watch|lookout|picke|lookout man|sentinel|spotter|sentry|scout
weak|pallid|spineless|wan|slack|anemic|wishy-washy|jerry-built|vulnerable|untoughened|lame|feeble|fragile|gutless|pale|flaccid|anaemic|slight|adynamic|tenuous|delicate|flimsy|powerless|weakened|shoddy|limp|thin|puny|namby-pamby|enervated|lax|debilitated|sick|faint|tender|asthenic
wear|wearable|article of clothing|habiliment|clothing|vesture
wearing|effortful|tiring|exhausting|wearying
weird|supernatural|eldritch|uncanny|unearthly
west|westerly|westmost|western|westernmost|westward|westbound|westside
whole|full-page|intact|complete|full-length|entire|integral|undivided|full|total|livelong
wicked|repellant|disgusting|loathsome|repellent|revolting|repelling|yucky|skanky|foul|distasteful|loathly|offensive|disgustful
wide|blanket|all-encompassing|extensive|all-inclusive|broad|across-the-board|all-embracing|panoptic|encompassing|comprehensive
wifi|wireless local area network|WiF|WLAN|wireless fidelity
wild|stormy|furious|raging|tempestuous|angry
willing|compliant|prepared|fain|happy|glad|volitional|ready|willing and able|inclined|voluntary|consenting|disposed
wise|sapient|omniscient|sage|advisable|politic|prudent|perspicacious|owlish|advised|sagacious|all-knowing|sapiential|well-advised
wizard|wizardly|magical|sorcerous|witching|charming|supernatural|magic
wolf|wildcat|beast|brute|savage
wonderful|grand|fantastic|marvelous|extraordinary|wondrous|howling|rattling|tremendous|marvellous|terrific
wondering|speculative|curious|inquisitive|questioning
word|Christian Bible|Good Book|Word of God|Holy Writ|Wor|Holy Scripture|Book|Scripture|Bible
workforce|manpower|work force|me|hands
workout|exercising|exercise|physical exercise|physical exertion
world|international|planetary|worldwide|global|world-wide
worldwide|universal|general|comprehensive|world-wide|ecumenical|cosmopolitan|oecumenical
worn|shopsoiled|attrited|decrepit|scruffy|weathered|mothy|eroded|weatherworn|frayed|run-down|ragged|seedy|woebegone|weather-beaten|well-worn|aged|eared|mangey|ratty|derelict|moth-eaten|old|waterworn|threadbare|raddled|tatty|clapped out|battered|wormy|worn-out|flea-bitten|dog-eared|vermiculate|shopworn|played out|worm-eaten|mangy|creaky|thumbed|shabby|tatterdemalion|tattered|scoured
worst|pessimal|pessimum|bottom|last-place|bad|lowest|inferior|last
worthy|praiseworthy|righteous|creditable|estimable|noteworthy|laudable|cum laude|exemplary|applaudable|honoured|honorable|worth|valuable|worthful|magna cum laude|honored|meritorious|meritable|notable|good|honourable|deserving|sacred|model|quotable|summa cum laude|commendable|worthwhile|meriting
wrapped|intent|engrossed|absorbed|enwrapped|attentive|captive
wrist|articulatio radiocarpea|carpus|wrist joint|radiocarpal joint
write|compose|write out|pen|indite
wrong|amiss|malfunctioning|haywire|nonfunctional|awry
yahoo|bumpkin|yokel|chawbacon|rube|hayseed|hick
yearly|period of time|annual|period|time period
yellow|chicken|chickenhearted|fearful|yellow-bellied|lily-livered|cowardly|white-livered